1
Adrian city: Archie city, Passaic town, 
Advance city: Bell City city, Zalma village, 
Affton CDP: Lakeshire city, Grantwood Village town, Marlborough village, St. George city, Wilbur Park village, Concord CDP, 
Agency town: Easton city, St. Joseph city, 
Airport Drive village: Carl Junction city, Oakland Park village, 
Alba city: Purcell city, Oronogo city, Carytown city, 
Albany city: Darlington village, Gentry village, New Hampton city, 
Aldrich village: Fair Play city, Dadeville village, Morrisville town, Walnut Grove city, 
Alexandria city: Wayland city, 
Allendale town: Denver village, Grant City town, 
Allenville village: Delta city, Whitewater town, Gordonville town, 
Alma city: Blackburn city, Corder city, Concordia city, 
Altamont town: Winston town, Gallatin city, 
Altenburg city: Frohna city, 
Alton city: Thayer city, 
Amazonia town: Savannah city, Country Club village, Fillmore city, 
Amity town: Maysville city, Clarksdale city, 
Amoret city: Amsterdam city, Foster town, 
Amsterdam city: Merwin town, Amoret city, 
Anderson city: Lanagan town, Goodman town, 
Annada town: Paynesville village, Elsberry city, 
Annapolis city: Des Arc village, Arcadia city, 
Anniston town: East Prairie city, Charleston city, 
Appleton City city: Montrose city, Rockville city, 
Arbela town: Granger town, South Gorin town, Memphis city, 
Arbyrd city: Cardwell city, Senath city, 
Arcadia city: Ironton city, Annapolis city, 
Archie city: Adrian city, Harrisonville city, 
Arcola village: Umber View Heights village, Greenfield city, Jerico Springs village, 
Argyle town: Freeburg village, Meta city, Vienna city, 
Arkoe town: Barnard city, Maryville city, 
Armstrong city: Fayette city, Glasgow city, 
Arnold city: Oakville CDP, Imperial CDP, 
Arrow Rock town: Blackwater city, Gilliam town, 
Asbury city: Waco town, 
Ashburn town: Frankford city, Louisiana city, 
Ash Grove city: Walnut Grove city, Everton city, Halltown town, 
Ashland city: Hartsburg town, 
Atlanta city: La Plata city, 
Augusta city: Gray Summit CDP, Washington city, 
Aullville village: Higginsville city, Corder city, 
Aurora city: Verona town, Marionville city, 
Auxvasse city: Kingdom City village, Mexico city, 
Ava city: Mansfield city, 
Avilla town: Reeds town, La Russell city, 
Avondale city: North Kansas City city, Oaks village, Randolph village, 
Bagnell town: Lakeland town, Eldon city, 
Baker village: Penermon village, Canalou city, Morehouse city, 
Bakersfield village: Gainesville city, West Plains city, 
Baldwin Park village: Pleasant Hill city, Strasburg town, Lone Jack village, 
Ballwin city: Winchester city, Ellisville city, 
Baring city: Edina city, Rutledge town, 
Barnard city: Bolckow city, Arkoe town, Guilford town, 
Barnett city: Eldon city, 
Barnhart CDP: Imperial CDP, Pevely city, 
Bates City village: Oak Grove city, Odessa city, Napoleon city, 
Battlefield town: Brookline village, Nixa city, Springfield city, 
Bella Villa city: Lemay CDP, St. George city, 
Bell City city: Advance city, Vanduser village, 
Belle city: Bland city, Freeburg village, 
Bellefontaine Neighbors city: Castle Point CDP, Riverview village, Spanish Lake CDP, 
Bellerive village: Bel-Nor village, Cool Valley city, Normandy city, Pasadena Park village, Bel-Ridge village, 
Bellflower city: Truxton village, High Hill city, Middletown town, 
Bel-Nor village: Bellerive village, Greendale city, 
Bel-Ridge village: Bellerive village, Kinloch city, 
Belton city: Grandview city, Raymore city, 
Benton city: Lambert village, Morley city, Kelso town, 
Benton City town: Rush Hill town, Vandiver village, Martinsburg town, 
Berger city: Hermann city, New Haven city, 
Berkeley city: Kinloch city, Woodson Terrace city, Hazelwood city, 
Bernie city: Malden city, Dexter city, 
Bertrand city: Diehlstadt town, Miner city, Charleston city, 
Bethany city: Ridgeway city, Coffey town, 
Bethel town: Shelbyville city, Newark town, Leonard town, 
Beverly Hills city: Glen Echo Park village, Hillsdale village, Normandy city, Northwoods city, Pasadena Hills city, Uplands Park village, Velda Village city, Velda Village Hills village, Country Club Hills city, 
Bevier city: Callao city, Macon city, 
Bigelow village: Big Lake village, Mound City city, Craig city, 
Big Lake village: Fortescue town, Bigelow village, 
Billings city: Clever city, Republic city, Marionville city, Halltown town, 
Birch Tree city: Winona city, Mountain View city, 
Birmingham village: Claycomo village, Randolph village, Sugar Creek city, 
Bismarck city: Irondale city, Iron Mountain Lake city, 
Blackburn city: Alma city, Mount Leonard town, 
Black Jack city: Castle Point CDP, 
Blackwater city: Nelson city, Arrow Rock town, Pilot Grove city, 
Blairstown city: Chilhowee town, Urich city, 
Bland city: Belle city, Owensville city, 
Blodgett town: Hay-Wood City village, Diehlstadt town, 
Bloomfield city: Dexter city, 
Bloomsdale city: Rocky Ridge village, Ste. Genevieve city, 
Blue Eye town: Kimberling City city, 
Blue Springs city: Lake Tapawingo city, Grain Valley city, Lake Lotawana city, 
Blythedale village: Eagleville town, Ridgeway city, Cainsville city, 
Bogard city: Carrollton city, Tina town, 
Bolckow city: Barnard city, Rea town, 
Bolivar city: Morrisville town, 
Bonne Terre city: Desloge city, Leadwood city, De Soto city, 
Boonville city: Franklin city, 
Bosworth city: Tina town, 
Bourbon city: St. Cloud village, Leasburg village, 
Bowling Green city: Tarrants village, Curryville city, 
Bragg City town: Pascola town, Kennett city, 
Brandsville city: Koshkonong town, West Plains city, 
Branson city: Hollister city, Table Rock village, Merriam Woods village, 
Brashear city: Gibbs town, Hurdland city, 
Braymer city: Ludlow town, Cowgill city, 
Breckenridge city: Mooresville village, Lock Springs town, 
Breckenridge Hills village: Charlack city, Overland city, St. Ann city, 
Brentwood city: Maplewood city, Richmond Heights city, Rock Hill city, Ladue city, 
Bridgeton city: Champ village, St. Ann city, 
Brimson village: Tindall town, Gilman City city, 
Bronaugh city: Moundville town, Liberal city, 
Brookfield city: Laclede city, Rothville village, 
Brookline village: Battlefield town, Republic city, Willard city, 
Brooklyn Heights village: Carterville city, Carthage city, 
Browning city: Purdin city, Milan city, 
Brownington town: Deepwater city, Lowry City city, 
Brumley town: Tuscumbia town, 
Brunswick city: Triplett city, De Witt city, Dalton town, 
Bucklin city: Marceline city, New Cambria town, 
Buckner city: Sibley village, Levasy city, 
Buffalo city: Louisburg village, Halfway village, 
Bunceton city: Pilot Grove city, Syracuse city, 
Bunker city: Centerville city, Viburnum town, 
Burgess town: Mindenmines city, Liberal city, 
Burlington Junction city: Clearmont city, Quitman town, 
Butler city: Passaic town, 
Butterfield village: Cassville city, Purdy city, 
Byrnes Mill city: High Ridge CDP, Scotsdale town, Eureka city, 
Cabool city: Mountain Grove city, Willow Springs city, 
Cainsville city: Mount Moriah town, Blythedale village, 
Cairo village: Jacksonville village, Moberly city, 
Caledonia village: Irondale city, 
Calhoun city: Windsor city, Leeton city, Tightwad village, 
California city: Clarksburg city, Centertown town, Jamestown town, 
Callao city: Bevier city, New Cambria town, 
Calverton Park village: Ferguson city, Florissant city, 
Camden city: Fleming city, Wellington city, Henrietta city, 
Camden Point city: Dearborn city, Platte City city, Ridgely town, 
Camdenton city: Linn Creek city, 
Cameron city: Osborn city, 
Campbell city: Holcomb city, Malden city, 
Canalou city: Baker village, Matthews city, 
Canton city: La Grange city, Monticello town, 
Cape Girardeau city: Scott City city, 
Cardwell city: Arbyrd city, 
Carl Junction city: Airport Drive village, Waco town, 
Carrollton city: Bogard city, Wakenda town, 
Carterville city: Webb City city, Brooklyn Heights village, Oronogo city, 
Carthage city: Brooklyn Heights village, Fidelity town, 
Caruthersville city: Hayti city, 
Carytown city: Alba city, Jasper city, 
Cassville city: Exeter city, Butterfield village, Chain-O-Lakes village, 
Castle Point CDP: Moline Acres city, Bellefontaine Neighbors city, Black Jack city, Dellwood city, 
Catron town: North Lilbourn village, Parma city, 
Cave town: Troy city, Hawk Point city, Silex village, 
Cedar Hill CDP: Cedar Hill Lakes village, Scotsdale town, 
Cedar Hill Lakes village: Cedar Hill CDP, 
Center city: The Landing village, New London city, 
Centertown town: St. Martins city, California city, 
Centerview town: Warrensburg city, Chilhowee town, 
Centerville city: Ellington city, Bunker city, 
Centralia city: Hallsville city, 
Chaffee city: Delta city, Oran city, 
Chain-O-Lakes village: Emerald Beach village, Cassville city, 
Chamois city: Mokane city, Morrison city, 
Champ village: Bridgeton city, Maryland Heights city, St. Charles city, 
Charlack city: St. John city, Sycamore Hills village, Vinita Park city, Breckenridge Hills village, 
Charleston city: Anniston town, Bertrand city, Wilson City town, 
Chesterfield city: Clarkson Valley city, Weldon Spring town, 
Chilhowee town: Blairstown city, Centerview town, 
Chillicothe city: Utica village, Chula city, 
Chula city: Laredo city, Chillicothe city, 
Clarence city: Leonard town, 
Clark city: Sturgeon city, Renick village, 
Clarksburg city: California city, Tipton city, 
Clarksdale city: Stewartsville city, Amity town, Easton city, Cosby town, 
Clarkson Valley city: Chesterfield city, Ellisville city, 
Clarksville city: Paynesville village, 
Clarkton city: Gideon city, Holcomb city, 
Claycomo village: Pleasant Valley city, Birmingham village, Glenaire village, 
Clayton city: Richmond Heights city, University City city, 
Clearmont city: Burlington Junction city, Elmo city, 
Cleveland town: West Line village, 
Clever city: Billings city, Hurley city, 
Cliff Village village: Redings Mill village, Shoal Creek Drive village, Dennis Acres village, Leawood village, Shoal Creek Estates town, Seneca city, 
Clifton Hill city: Huntsville city, Salisbury city, 
Climax Springs village: Macks Creek city, Cross Timbers city, 
Clinton city: Deepwater city, La Due village, 
Clyde village: Conception Junction town, Ravenwood town, Stanberry city, 
Cobalt City village: Fredericktown city, Marquand city, 
Coffey town: Jameson town, Gilman City city, Pattonsburg city, Bethany city, 
Cole Camp city: Ionia town, 
Collins village: Gerster town, 
Columbia city: Lupus town, 
Commerce town: Kelso town, 
Conception Junction town: Clyde village, Guilford town, 
Concord CDP: Affton CDP, Mehlville CDP, Sappington CDP, 
Concordia city: Emma city, Alma city, 
Conway city: Phillipsburg town, Niangua city, 
Cool Valley city: Bellerive village, Ferguson city, 
Cooter city: Steele city, 
Corder city: Alma city, Aullville village, Dover town, 
Corning town: Craig city, Fairfax city, 
Cosby town: Clarksdale city, 
Cottleville town: Weldon Spring town, St. Peters city, O'Fallon city, 
Country Club village: St. Joseph city, Amazonia town, 
Country Club Hills city: Flordell Hills city, Jennings city, Beverly Hills city, 
Country Life Acres village: Crystal Lake Park city, Town and Country city, Des Peres city, 
Cowgill city: Polo city, Braymer city, 
Craig city: Corning town, Bigelow village, 
Crane city: Hurley city, 
Creighton city: Urich city, Garden City city, 
Crestwood city: Grantwood Village town, Oakland city, Sunset Hills city, 
Creve Coeur city: Westwood village, 
Crocker city: Iberia city, Waynesville city, Richland city, Dixon city, 
Cross Timbers city: Preston town, Climax Springs village, 
Crystal City city: Festus city, Herculaneum city, 
Crystal Lake Park city: Country Life Acres village, Frontenac city, Huntleigh city, Westwood village, Kirkwood city, 
Crystal Lakes village: Homestead village, Excelsior Estates village, Woods Heights city, 
Cuba city: Leasburg village, Steelville city, 
Curryville city: Bowling Green city, Frankford city, Vandalia city, 
Dadeville village: Aldrich village, 
Dalton town: Keytesville city, Brunswick city, 
Dardenne Prairie town: O'Fallon city, Lake St. Louis city, 
Darlington village: Albany city, Ford City town, 
Dearborn city: Camden Point city, 
Deepwater city: Brownington town, Clinton city, 
Deerfield village: Moundville town, Richards town, 
De Kalb town: Rushville town, 
Dellwood city: Ferguson city, Castle Point CDP, 
Delta city: Allenville village, Chaffee city, 
Dennis Acres village: Cliff Village village, Joplin city, 
Denver village: Allendale town, 
Des Arc village: Annapolis city, Piedmont city, 
Desloge city: Flat River city, Bonne Terre city, 
De Soto city: Hillsboro city, Olympian Village city, Bonne Terre city, 
Des Peres city: Country Life Acres village, 
De Witt city: Miami city, Brunswick city, 
Dexter city: Essex city, Bloomfield city, Bernie city, Dudley city, 
Diamond town: Fidelity town, Granby city, 
Diehlstadt town: Bertrand city, Blodgett town, 
Diggins village: Fordland city, Seymour city, Marshfield city, 
Dixon city: Crocker city, Doolittle city, 
Doniphan city: Grandin city, Naylor city, 
Doolittle city: Newburg city, Rolla city, Dixon city, 
Dover town: Corder city, Norborne city, 
Downing city: Lancaster city, 
Drexel city: Merwin town, 
Dudley city: Fisk city, Dexter city, Puxico city, 
Duenweg city: Duquesne village, 
Duquesne village: Oakland Park village, Silver Creek village, Duenweg city, 
Eagleville town: Blythedale village, 
East Lynne town: Gunn City village, Garden City city, Harrisonville city, 
Easton city: Agency town, Clarksdale city, Gower city, 
East Prairie city: Anniston town, 
Edgar Springs city: Licking city, Newburg city, Salem city, 
Edgerton city: Ridgely town, Trimble city, Gower city, 
Edina city: Baring city, Hurdland city, Novelty town, 
Edmundson village: Woodson Terrace city, 
Eldon city: Olean town, Barnett city, Bagnell town, 
El Dorado Springs city: Harwood town, 
Ellington city: Centerville city, Van Buren town, 
Ellisville city: Ballwin city, Clarkson Valley city, 
Ellsinore town: Grandin city, Mill Spring village, 
Elmer city: South Gifford village, Ethel town, 
Elmira village: Lawson city, Polo city, 
Elmo city: Clearmont city, 
Elsberry city: Annada town, 
Elvins city: Rivermines village, Flat River city, 
Emerald Beach village: Chain-O-Lakes village, 
Eminence city: Winona city, 
Emma city: Concordia city, Sweet Springs city, 
Eolia village: Whiteside village, Paynesville village, 
Essex city: Penermon village, Dexter city, 
Esther city: Flat River city, Leadington city, 
Ethel town: Elmer city, New Cambria town, 
Eugene town: Olean town, Tuscumbia town, 
Eureka city: Byrnes Mill city, Pacific city, 
Everton city: Ash Grove city, South Greenfield village, 
Ewing city: Monticello town, 
Excelsior Estates village: Crystal Lakes village, Lawson city, 
Excelsior Springs city: Homestead village, Prathersville village, 
Exeter city: Cassville city, Washburn city, 
Fairfax city: Corning town, Tarkio city, Rock Port city, 
Fair Grove city: Strafford city, Pleasant Hope city, 
Fair Play city: Aldrich village, 
Fairview town: Wheaton city, Stark City town, 
Farber city: Laddonia city, Vandalia city, 
Farley village: Platte City city, 
Farmington city: Leadington city, 
Fayette city: Armstrong city, New Franklin city, 
Fenton city: Sunset Hills city, Valley Park city, Murphy CDP, 
Ferguson city: Calverton Park village, Cool Valley city, Dellwood city, 
Ferrelview village: Platte Woods city, Smithville city, 
Festus city: Crystal City city, Olympian Village city, 
Fidelity town: Carthage city, Diamond town, 
Fillmore city: Amazonia town, Graham town, 
Fisk city: Dudley city, Poplar Bluff city, Qulin city, 
Flat River city: Desloge city, Elvins city, Esther city, 
Fleming city: Camden city, Napoleon city, Orrick city, 
Flemington village: Humansville city, Weaubleau city, 
Flint Hill village: Wentzville city, Josephville village, Moscow Mills city, 
Flordell Hills city: Country Club Hills city, 
Florida village: Stoutsville village, 
Florissant city: Calverton Park village, Portage Des Sioux city, 
Foley city: Winfield city, 
Ford City town: King City city, Darlington village, Stanberry city, 
Fordland city: Diggins village, Rogersville town, 
Forest City city: Oregon city, Fortescue town, 
Foristell city: Wright City city, Wentzville city, 
Forsyth city: Rockaway Beach city, Taneyville village, 
Fortescue town: Big Lake village, Forest City city, 
Fort Leonard Wood CDP: St. Robert city, 
Foster town: Hume town, Amoret city, 
Frankford city: New London city, Ashburn town, Curryville city, 
Franklin city: New Franklin city, Boonville city, 
Fredericktown city: Junction City village, Cobalt City village, 
Freeburg village: Argyle town, Belle city, 
Freeman city: Lake Annette village, West Line village, 
Freistatt town: Hoberg village, Stotts City city, Monett city, Verona town, 
Fremont Hills city: Nixa city, Ozark city, 
Frohna city: Altenburg city, Old Appleton town, 
Frontenac city: Crystal Lake Park city, 
Fulton city: Kingdom City village, 
Gainesville city: Sundown village, Bakersfield village, 
Galena city: Reeds Spring city, Hurley city, 
Gallatin city: Jameson town, Altamont town, 
Galt city: Humphreys town, Osgood town, Laredo city, 
Garden City city: East Lynne town, Creighton city, 
Gasconade city: Rhineland town, Morrison city, 
Gentry village: Worth town, Albany city, 
Gerald city: Rosebud city, Leslie village, 
Gerster town: Weaubleau city, Collins village, Vista village, 
Gibbs town: Brashear city, La Plata city, 
Gideon city: Clarkton city, Tallapoosa city, North Wardell village, 
Gilliam town: Slater city, Arrow Rock town, Glasgow city, 
Gilman City city: Brimson village, Coffey town, 
Gladstone city: Oakview village, 
Glasgow city: Armstrong city, Gilliam town, 
Glasgow Village CDP: Riverview village, 
Glenaire village: Claycomo village, Liberty city, 
Glenallen town: Marble Hill city, Marquand city, Zalma village, 
Glendale city: Oakland city, Rock Hill city, Warson Woods city, Webster Groves city, 
Glen Echo Park village: Beverly Hills city, 
Glenwood village: Lancaster city, Queen City city, Livonia village, 
Golden City city: Lockwood city, 
Goodman town: Anderson city, Neosho city, 
Gordonville town: Jackson city, Allenville village, 
Gower city: Edgerton city, Easton city, Plattsburg city, 
Graham town: Maitland city, Fillmore city, 
Grain Valley city: Blue Springs city, Oak Grove city, 
Granby city: Newtonia town, Diamond town, Neosho city, 
Grandin city: Ellsinore town, Doniphan city, Van Buren town, 
Grand Pass town: Malta Bend town, Waverly city, Wakenda town, 
Grandview city: Belton city, 
Granger town: Arbela town, Luray town, 
Grant City town: Worth town, Allendale town, 
Grantwood Village town: Affton CDP, Crestwood city, 
Gravois Mills village: Laurie village, Versailles city, 
Gray Summit CDP: Pacific city, Villa Ridge CDP, Augusta city, 
Greencastle city: Green City city, 
Green City city: Greencastle city, Pollock village, 
Greendale city: Bel-Nor village, Hanley Hills village, Pagedale city, 
Greenfield city: South Greenfield village, Lockwood city, Arcola village, 
Green Ridge town: Windsor city, Ionia town, La Monte city, 
Greentop city: Queen City city, Kirksville city, 
Greenville city: Williamsville city, 
Greenwood city: Lake Winnebago city, Lee's Summit city, Pleasant Hill city, Lake Lotawana city, 
Guilford town: Barnard city, Conception Junction town, 
Gunn City village: East Lynne town, La Tour town, Strasburg town, 
Hale city: Sumner town, Tina town, 
Halfway village: Buffalo city, Pleasant Hope city, 
Hallsville city: Centralia city, Sturgeon city, 
Halltown town: Ash Grove city, Billings city, 
Hamilton city: Kidder city, Kingston city, 
Hanley Hills village: Greendale city, Vinita Terrace village, University City city, 
Hannibal city: New London city, Palmyra city, 
Hardin city: Lexington city, 
Harris town: Newtown town, Osgood town, 
Harrisburg town: Higbee city, 
Harrisonville city: East Lynne town, Archie city, 
Hartsburg town: Ashland city, St. Martins city, 
Hartville city: Mansfield city, Norwood city, 
Hartwell village: Urich city, La Due village, 
Harwood town: Schell City city, Walker city, El Dorado Springs city, 
Hawk Point city: Cave town, Truxton village, 
Hayti city: Hayti Heights city, Caruthersville city, 
Hayti Heights city: Hayti city, Pascola town, Steele city, 
Hayward town: Portageville city, 
Hay-Wood City village: Morley city, Blodgett town, Vanduser village, 
Hazelwood city: Berkeley city, 
Henrietta city: Richmond city, Lexington city, Camden city, 
Herculaneum city: Crystal City city, Horine CDP, Pevely city, 
Hermann city: McKittrick town, Rhineland town, Berger city, 
Hermitage city: Wheatland city, Preston town, 
Higbee city: Renick village, Harrisburg town, 
Higginsville city: Aullville village, Mayview city, 
High Hill city: Jonesburg city, New Florence city, Bellflower city, McKittrick town, 
High Ridge CDP: Parkdale town, Byrnes Mill city, 
Hillsboro city: De Soto city, 
Hillsdale village: Beverly Hills city, Wellston city, St. Louis city, 
Hoberg village: Mount Vernon city, Freistatt town, 
Holcomb city: Clarkton city, Campbell city, 
Holden city: Kingsville city, 
Holland town: Steele city, 
Holliday village: Madison city, Paris city, 
Hollister city: Branson city, 
Holt city: Kearney city, Lathrop city, 
Holts Summit city: Lake Mykee Town village, Jefferson City city, 
Homestead village: Crystal Lakes village, Excelsior Springs city, 
Homestown city: North Wardell village, Pascola town, 
Hopkins city: Pickering town, 
Horine CDP: Herculaneum city, 
Hornersville city: Senath city, 
Houston city: Raymondville town, 
Houstonia city: Sweet Springs city, Hughesville village, La Monte city, 
Houston Lake city: Northmoor city, Riverside city, Lake Waukomis city, 
Howardville city: Lilbourn city, Marston city, New Madrid city, 
Hughesville village: Houstonia city, Sedalia city, 
Humansville city: Flemington village, 
Hume town: Foster town, Stotesbury town, 
Humphreys town: Galt city, 
Hunnewell city: Monroe City city, Stoutsville village, Shelbina city, 
Huntleigh city: Crystal Lake Park city, Warson Woods city, 
Huntsville city: Moberly city, Clifton Hill city, 
Hurdland city: Brashear city, Edina city, 
Hurley city: Crane city, Clever city, Galena city, 
Iatan village: Lewis and Clark Village town, Weston city, 
Iberia city: Crocker city, St. Elizabeth town, 
Imperial CDP: Kimmswick city, Barnhart CDP, Arnold city, 
Independence city: Lake Tapawingo city, Sugar Creek city, 
Indian Point village: Lakeview city, Table Rock village, Kimberling City city, 
Ionia town: Lincoln city, Cole Camp city, Green Ridge town, 
Irondale city: Bismarck city, Leadwood city, Caledonia village, Mineral Point town, 
Iron Gates village: Shoal Creek Drive village, 
Iron Mountain Lake city: Pilot Knob city, Bismarck city, 
Ironton city: Arcadia city, Pilot Knob city, 
Jackson city: Gordonville town, Pocahontas town, 
Jacksonville village: Cairo village, 
Jameson town: Gallatin city, Coffey town, 
Jamesport city: Lock Springs town, 
Jamestown town: Lupus town, California city, 
Jasper city: Carytown city, Lamar Heights village, 
Jefferson City city: Wardsville town, Holts Summit city, St. Martins city, 
Jennings city: Country Club Hills city, 
Jerico Springs village: Arcola village, Milford village, 
Jonesburg city: High Hill city, 
Joplin city: Dennis Acres village, 
Josephville village: Lake St. Louis city, Flint Hill village, St. Paul village, 
Junction City village: Fredericktown city, 
Kahoka city: Revere town, Wayland city, Luray town, 
Kansas City city: North Kansas City city, 
Kearney city: Mosby city, Holt city, 
Kelso town: Scott City city, Benton city, Commerce town, 
Kennett city: Bragg City town, Senath city, 
Keytesville city: Dalton town, Salisbury city, 
Kidder city: Winston town, Hamilton city, 
Kimberling City city: Indian Point village, Blue Eye town, 
Kimmswick city: Imperial CDP, 
King City city: Ford City town, Union Star town, 
Kingdom City village: Auxvasse city, Fulton city, 
Kingston city: Polo city, Hamilton city, 
Kingsville city: Holden city, Strasburg town, 
Kinloch city: Berkeley city, Bel-Ridge village, 
Kirksville city: Millard village, Novinger city, Greentop city, 
Kirkwood city: Crystal Lake Park city, 
Knob Noster city: Whiteman AFB CDP, La Monte city, 
Knox City city: La Belle city, 
Koshkonong town: Brandsville city, Thayer city, 
La Belle city: Knox City city, Lewistown town, Newark town, 
Laclede city: Brookfield city, Linneus city, Meadville city, 
Laddonia city: Farber city, Rush Hill town, 
La Due village: Clinton city, Montrose city, Hartwell village, 
Ladue city: Brentwood city, 
La Grange city: Canton city, 
Lake Annette village: Freeman city, Peculiar city, 
Lakeland town: Lakeview village, Bagnell town, 
Lake Lotawana city: Blue Springs city, Greenwood city, 
Lake Mykee Town village: Holts Summit city, New Bloomfield city, 
Lake Ozark city: Lakeside city, Osage Beach city, Village of Four Seasons town, 
Lake St. Louis city: Josephville village, Dardenne Prairie town, 
Lakeshire city: Affton CDP, 
Lakeside city: Lakeview village, Lake Ozark city, 
Lake Tapawingo city: Blue Springs city, Independence city, 
Lakeview village: Lakeland town, Lakeside city, 
Lakeview city: Reeds Spring city, Indian Point village, 
Lake Waukomis city: Platte Woods city, Houston Lake city, 
Lake Winnebago city: Greenwood city, Raymore city, 
Lamar city: Lamar Heights village, 
Lamar Heights village: Lamar city, Jasper city, 
Lambert village: Benton city, 
La Monte city: Houstonia city, Knob Noster city, Green Ridge town, 
Lanagan town: Anderson city, Noel city, Pineville town, 
Lancaster city: Glenwood village, Downing city, 
La Plata city: Millard village, Gibbs town, Atlanta city, 
Laredo city: Chula city, Galt city, 
La Russell city: Avilla town, 
Lathrop city: Holt city, Turney village, 
La Tour town: Gunn City village, 
Laurie village: Sunrise Beach village, Gravois Mills village, 
Lawson city: Excelsior Estates village, Elmira village, 
Leadington city: Esther city, Farmington city, 
Leadwood city: Bonne Terre city, Irondale city, 
Leasburg village: Bourbon city, Cuba city, 
Leawood village: Cliff Village village, Saginaw village, 
Lebanon city: Twin Bridges town, Phillipsburg town, 
Lee's Summit city: Unity Village village, Greenwood city, 
Leeton city: Calhoun city, 
Lemay CDP: Bella Villa city, 
Leonard town: Novelty town, Bethel town, Clarence city, 
Leslie village: Gerald city, Oak Grove village, 
Levasy city: Napoleon city, Buckner city, 
Lewis and Clark Village town: Rushville town, Iatan village, 
Lewistown town: La Belle city, Monticello town, 
Lexington city: Henrietta city, Hardin city, Mayview city, 
Liberal city: Burgess town, Bronaugh city, 
Liberty city: Glenaire village, 
Licking city: Raymondville town, Edgar Springs city, 
Lilbourn city: North Lilbourn village, Howardville city, 
Lincoln city: Ionia town, Warsaw city, 
Linn city: Westphalia city, 
Linn Creek city: Camdenton city, Osage Beach city, 
Linneus city: Purdin city, Laclede city, 
Lithium village: St. Mary city, Perryville city, 
Livonia village: Worthington village, Glenwood village, 
Lock Springs town: Breckenridge city, Jamesport city, 
Lockwood city: Greenfield city, Golden City city, 
Lohman town: St. Martins city, Russellville city, 
Lone Jack village: Baldwin Park village, 
Longtown town: Old Appleton town, Perryville city, 
Louisburg village: Urbana city, Buffalo city, 
Louisiana city: Ashburn town, 
Lowry City city: Osceola city, Brownington town, 
Lucerne village: Powersville village, Newtown town, 
Ludlow town: Mooresville village, Braymer city, 
Lupus town: Jamestown town, Wooldridge town, Columbia city, 
Luray town: Wyaconda city, Granger town, Kahoka city, 
McFall city: Pattonsburg city, 
Mac Kenzie village: Shrewsbury city, Marlborough village, 
McKittrick town: Hermann city, High Hill city, 
Macks Creek city: Climax Springs village, 
Macon city: Bevier city, 
Madison city: Holliday village, 
Maitland city: Graham town, Skidmore city, Mound City city, 
Malden city: Bernie city, Campbell city, 
Malta Bend town: Grand Pass town, Mount Leonard town, Marshall city, 
Manchester city: Winchester city, Twin Oaks village, 
Mansfield city: Hartville city, Ava city, Seymour city, 
Maplewood city: Brentwood city, 
Marble Hill city: Glenallen town, 
Marceline city: Bucklin city, Rothville village, 
Marionville city: Aurora city, Billings city, 
Marlborough village: Affton CDP, Mac Kenzie village, 
Marquand city: Cobalt City village, Glenallen town, 
Marshall city: Malta Bend town, 
Marshfield city: Niangua city, Diggins village, 
Marston city: Howardville city, Portageville city, 
Marthasville city: Washington city, 
Martinsburg town: Wellsville city, Benton City town, 
Maryland Heights city: Champ village, 
Maryville city: Arkoe town, Pickering town, 
Matthews city: Canalou city, 
Maysville city: Amity town, 
Mayview city: Higginsville city, Lexington city, 
Meadville city: Wheeling city, Laclede city, 
Mehlville CDP: Concord CDP, Oakville CDP, 
Memphis city: Arbela town, 
Mendon town: Rothville village, Triplett city, Sumner town, 
Mercer town: South Lineville town, Princeton city, 
Merriam Woods village: Rockaway Beach city, Branson city, 
Merwin town: Amsterdam city, Drexel city, 
Meta city: St. Thomas town, St. Elizabeth town, Argyle town, 
Metz town: Rich Hill city, Stotesbury town, 
Mexico city: Vandiver village, Auxvasse city, 
Miami city: De Witt city, 
Middletown town: Bellflower city, 
Milan city: Browning city, Pollock village, 
Milford village: Jerico Springs village, Sheldon city, 
Millard village: Kirksville city, La Plata city, South Gifford village, 
Miller city: Mount Vernon city, 
Mill Spring village: Piedmont city, Ellsinore town, Williamsville city, 
Milo town: Nevada city, Sheldon city, 
Mindenmines city: Burgess town, 
Miner city: Sikeston city, Bertrand city, 
Mineral Point town: Potosi city, Irondale city, 
Missouri City city: Mosby city, 
Moberly city: Renick village, Cairo village, Huntsville city, 
Mokane city: Chamois city, 
Moline Acres city: Castle Point CDP, 
Monett city: Pierce City city, Freistatt town, Purdy city, 
Monroe City city: Hunnewell city, The Landing village, 
Montgomery City city: New Florence city, Wellsville city, 
Monticello town: Ewing city, Lewistown town, Canton city, 
Montrose city: Appleton City city, La Due village, 
Mooresville village: Breckenridge city, Ludlow town, Utica village, 
Morehouse city: Baker village, Sikeston city, 
Morley city: Hay-Wood City village, Oran city, Benton city, 
Morrison city: Gasconade city, Chamois city, 
Morrisville town: Bolivar city, Aldrich village, Pleasant Hope city, 
Mosby city: Prathersville village, Kearney city, Missouri City city, 
Moscow Mills city: Troy city, Flint Hill village, 
Mound City city: Bigelow village, Maitland city, 
Moundville town: Bronaugh city, Deerfield village, Nevada city, 
Mountain Grove city: Norwood city, Cabool city, 
Mountain View city: Summersville city, Birch Tree city, 
Mount Leonard town: Malta Bend town, Blackburn city, 
Mount Moriah town: Cainsville city, 
Mount Vernon city: Hoberg village, Miller city, 
Murphy CDP: Parkdale town, Fenton city, 
Napoleon city: Levasy city, Fleming city, Bates City village, 
Naylor city: Neelyville city, Doniphan city, 
Neck City city: Purcell city, 
Neelyville city: Naylor city, Poplar Bluff city, 
Nelson city: Blackwater city, 
Neosho city: Goodman town, Granby city, 
Nevada city: Milo town, Moundville town, Walker city, 
Newark town: Bethel town, La Belle city, 
New Bloomfield city: Lake Mykee Town village, 
Newburg city: Doolittle city, Edgar Springs city, 
New Cambria town: Callao city, Ethel town, Bucklin city, 
New Florence city: High Hill city, Montgomery City city, 
New Franklin city: Franklin city, Fayette city, 
New Hampton city: Albany city, 
New Haven city: Berger city, 
New London city: Frankford city, Hannibal city, Center city, 
New Madrid city: Howardville city, 
New Melle village: Wentzville city, 
Newtonia town: Stark City town, Ritchey town, Granby city, 
Newtown town: Harris town, Lucerne village, 
Niangua city: Marshfield city, Conway city, 
Nixa city: Fremont Hills city, Battlefield town, 
Noel city: Lanagan town, South West City town, 
Norborne city: Dover town, 
Normandy city: Bellerive village, Beverly Hills city, Norwood Court town, 
North Kansas City city: Avondale city, Kansas City city, 
North Lilbourn village: Lilbourn city, Catron town, 
Northmoor city: Houston Lake city, Oaks village, 
North Wardell village: Wardell town, Homestown city, Gideon city, 
Northwoods city: Beverly Hills city, Pine Lawn city, 
Norwood city: Mountain Grove city, Hartville city, 
Norwood Court town: Normandy city, 
Novelty town: Leonard town, Edina city, 
Novinger city: Kirksville city, 
Oak Grove city: Bates City village, Grain Valley city, 
Oak Grove village: Sullivan city, Leslie village, 
Oakland city: Crestwood city, Glendale city, 
Oakland Park village: Duquesne village, Webb City city, Airport Drive village, 
Oak Ridge town: Old Appleton town, Pocahontas town, Sedgewickville village, 
Oaks village: Oakview village, Oakwood village, Oakwood Park village, Northmoor city, Avondale city, 
Oakview village: Gladstone city, Oaks village, 
Oakville CDP: Arnold city, Mehlville CDP, 
Oakwood village: Oaks village, 
Oakwood Park village: Oaks village, 
Odessa city: Bates City village, 
O'Fallon city: Dardenne Prairie town, Cottleville town, 
Old Appleton town: Frohna city, Longtown town, Oak Ridge town, 
Old Monroe city: Winfield city, St. Paul village, 
Olean town: Eldon city, Eugene town, Russellville city, 
Olivette city: Overland city, 
Olympian Village city: De Soto city, Festus city, 
Oran city: Morley city, Chaffee city, 
Oregon city: Forest City city, 
Oronogo city: Carterville city, Alba city, 
Orrick city: Fleming city, 
Osage Beach city: Lake Ozark city, Linn Creek city, 
Osborn city: Cameron city, Turney village, 
Osceola city: Vista village, Lowry City city, Roscoe village, 
Osgood town: Galt city, Harris town, 
Otterville city: Smithton city, Syracuse city, 
Overland city: Breckenridge Hills village, Olivette city, 
Owensville city: Rosebud city, Bland city, 
Ozark city: Fremont Hills city, Sparta city, 
Pacific city: Gray Summit CDP, Eureka city, 
Pagedale city: Greendale city, 
Palmyra city: Hannibal city, 
Paris city: Holliday village, Stoutsville village, 
Parkdale town: High Ridge CDP, Murphy CDP, 
Parkville city: Platte Woods city, Weatherby Lake city, 
Parkway village: St. Clair city, 
Parma city: Risco city, Catron town, 
Parnell city: Sheridan town, Ravenwood town, 
Pasadena Hills city: Beverly Hills city, 
Pasadena Park village: Bellerive village, 
Pascola town: Hayti Heights city, Homestown city, Bragg City town, 
Passaic town: Butler city, Adrian city, 
Pattonsburg city: McFall city, Coffey town, 
Paynesville village: Annada town, Clarksville city, Eolia village, 
Peculiar city: Lake Annette village, Raymore city, 
Peerless Park village: Twin Oaks village, Valley Park city, 
Penermon village: Essex city, Baker village, 
Perry city: The Landing village, 
Perryville city: Lithium village, Longtown town, 
Pevely city: Herculaneum city, Barnhart CDP, 
Phelps City town: Rock Port city, Watson village, 
Phillipsburg town: Conway city, Lebanon city, 
Pickering town: Hopkins city, Maryville city, 
Piedmont city: Mill Spring village, Des Arc village, 
Pierce City city: Monett city, Wentworth village, 
Pilot Grove city: Blackwater city, Bunceton city, 
Pilot Knob city: Ironton city, Iron Mountain Lake city, 
Pine Lawn city: Northwoods city, 
Pineville town: Lanagan town, 
Platte City city: Tracy city, Camden Point city, Farley village, 
Platte Woods city: Lake Waukomis city, Parkville city, Ferrelview village, 
Plattsburg city: Gower city, 
Pleasant Hill city: Baldwin Park village, Greenwood city, 
Pleasant Hope city: Fair Grove city, Halfway village, Morrisville town, 
Pleasant Valley city: Claycomo village, 
Pocahontas town: Oak Ridge town, Jackson city, 
Pollock village: Unionville city, Green City city, Milan city, 
Polo city: Kingston city, Cowgill city, Elmira village, 
Poplar Bluff city: Fisk city, Neelyville city, 
Portage Des Sioux city: Florissant city, 
Portageville city: Hayward town, Marston city, 
Potosi city: Mineral Point town, 
Powersville village: Lucerne village, 
Prairie Home city: Wooldridge town, 
Prathersville village: Mosby city, Excelsior Springs city, 
Preston town: Cross Timbers city, Hermitage city, Urbana city, 
Princeton city: Mercer town, Spickard city, 
Purcell city: Neck City city, Alba city, 
Purdin city: Browning city, Linneus city, 
Purdy city: Butterfield village, Monett city, 
Puxico city: Dudley city, 
Queen City city: Greentop city, Glenwood village, 
Quitman town: Burlington Junction city, Skidmore city, 
Qulin city: Fisk city, 
Randolph village: Birmingham village, Avondale city, 
Ravenwood town: Clyde village, Parnell city, 
Raymondville town: Houston city, Licking city, Summersville city, 
Raymore city: Belton city, Lake Winnebago city, Peculiar city, 
Raytown city: Unity Village village, 
Rayville village: Woods Heights city, Richmond city, 
Rea town: Rosendale city, Bolckow city, 
Redings Mill village: Cliff Village village, 
Reeds town: Sarcoxie city, Avilla town, 
Reeds Spring city: Lakeview city, Galena city, 
Renick village: Moberly city, Clark city, Higbee city, 
Republic city: Brookline village, Billings city, 
Revere town: Kahoka city, 
Rhineland town: Gasconade city, Hermann city, 
Richards town: Stotesbury town, Deerfield village, 
Rich Hill city: Metz town, 
Richland city: Stoutland village, Crocker city, 
Richmond city: Henrietta city, Rayville village, 
Richmond Heights city: Clayton city, Brentwood city, 
Ridgely town: Edgerton city, Smithville city, Camden Point city, 
Ridgeway city: Blythedale village, Bethany city, 
Risco city: Tallapoosa city, Parma city, 
Ritchey town: Newtonia town, Wentworth village, 
Rivermines village: Elvins city, 
Riverside city: Houston Lake city, 
Riverview village: Bellefontaine Neighbors city, Glasgow Village CDP, 
Rocheport city: Wooldridge town, 
Rockaway Beach city: Merriam Woods village, Forsyth city, 
Rock Hill city: Brentwood city, Glendale city, 
Rock Port city: Phelps City town, Fairfax city, 
Rockville city: Schell City city, Appleton City city, 
Rocky Ridge village: Bloomsdale city, 
Rogersville town: Fordland city, Sparta city, 
Rolla city: Doolittle city, St. James city, 
Roscoe village: Osceola city, 
Rosebud city: Gerald city, Owensville city, 
Rosendale city: Rea town, Savannah city, 
Rothville village: Mendon town, Marceline city, Brookfield city, 
Rush Hill town: Benton City town, Laddonia city, 
Rushville town: Lewis and Clark Village town, De Kalb town, 
Russellville city: Lohman town, Olean town, 
Rutledge town: South Gorin town, Baring city, 
Saginaw village: Silver Creek village, Leawood village, 
St. Ann city: Breckenridge Hills village, Bridgeton city, 
St. Charles city: Champ village, 
St. Clair city: Parkway village, Union city, 
St. Cloud village: Bourbon city, Sullivan city, 
Ste. Genevieve city: St. Mary city, Bloomsdale city, 
St. Elizabeth town: Meta city, Iberia city, 
St. George city: Affton CDP, Bella Villa city, 
St. James city: Rolla city, 
St. John city: Charlack city, 
St. Joseph city: Country Club village, Agency town, 
St. Louis city: Hillsdale village, 
St. Martins city: Lohman town, Centertown town, Hartsburg town, Jefferson City city, 
St. Mary city: Lithium village, Ste. Genevieve city, 
St. Paul village: Josephville village, Old Monroe city, 
St. Peters city: Cottleville town, 
St. Robert city: Waynesville city, Fort Leonard Wood CDP, 
St. Thomas town: Meta city, Wardsville town, 
Salem city: Edgar Springs city, 
Salisbury city: Clifton Hill city, Keytesville city, 
Sappington CDP: Concord CDP, 
Sarcoxie city: Reeds town, Wentworth village, 
Savannah city: Amazonia town, Rosendale city, 
Schell City city: Rockville city, Harwood town, 
Scotsdale town: Byrnes Mill city, Cedar Hill CDP, 
Scott City city: Kelso town, Cape Girardeau city, 
Sedalia city: Smithton city, Hughesville village, 
Sedgewickville village: Oak Ridge town, 
Seligman city: Washburn city, 
Senath city: Arbyrd city, Hornersville city, Kennett city, 
Seneca city: Cliff Village village, 
Seymour city: Diggins village, Mansfield city, 
Shelbina city: Shelbyville city, Hunnewell city, 
Shelbyville city: Bethel town, Shelbina city, 
Sheldon city: Milo town, Milford village, 
Sheridan town: Parnell city, 
Shoal Creek Drive village: Cliff Village village, Iron Gates village, 
Shoal Creek Estates town: Cliff Village village, 
Shrewsbury city: Mac Kenzie village, 
Sibley village: Buckner city, 
Sikeston city: Miner city, Morehouse city, 
Silex village: Whiteside village, Cave town, 
Silver Creek village: Saginaw village, Duquesne village, 
Skidmore city: Maitland city, Quitman town, 
Slater city: Gilliam town, 
Smithton city: Otterville city, Sedalia city, 
Smithville city: Ridgely town, Ferrelview village, 
South Gifford village: Elmer city, Millard village, 
South Gorin town: Rutledge town, Arbela town, 
South Greenfield village: Greenfield city, Everton city, 
South Lineville town: Mercer town, 
South West City town: Noel city, 
Spanish Lake CDP: Bellefontaine Neighbors city, 
Sparta city: Ozark city, Rogersville town, 
Spickard city: Tindall town, Princeton city, 
Springfield city: Battlefield town, 
Stanberry city: Ford City town, Clyde village, 
Stark City town: Newtonia town, Stella town, Fairview town, 
Steele city: Holland town, Cooter city, Hayti Heights city, 
Steelville city: Cuba city, 
Stella town: Stark City town, 
Stewartsville city: Clarksdale city, 
Stockton city: Umber View Heights village, 
Stotesbury town: Richards town, Hume town, Metz town, 
Stotts City city: Freistatt town, 
Stoutland village: Richland city, 
Stoutsville village: Florida village, Hunnewell city, Paris city, 
Stover city: Versailles city, 
Strafford city: Fair Grove city, 
Strasburg town: Baldwin Park village, Gunn City village, Kingsville city, 
Sturgeon city: Clark city, Hallsville city, 
Sugar Creek city: Birmingham village, Independence city, 
Sullivan city: Oak Grove village, St. Cloud village, 
Summersville city: Mountain View city, Raymondville town, 
Sumner town: Hale city, Mendon town, 
Sundown village: Theodosia village, Gainesville city, 
Sunrise Beach village: Laurie village, Village of Four Seasons town, 
Sunset Hills city: Crestwood city, Fenton city, 
Sweet Springs city: Emma city, Houstonia city, 
Sycamore Hills village: Charlack city, 
Syracuse city: Tipton city, Bunceton city, Otterville city, 
Table Rock village: Branson city, Indian Point village, 
Tallapoosa city: Risco city, Gideon city, 
Taneyville village: Forsyth city, 
Taos city: Wardsville town, Westphalia city, 
Tarkio city: Fairfax city, Westboro city, 
Tarrants village: Bowling Green city, 
Thayer city: Koshkonong town, Alton city, 
The Landing village: Monroe City city, Perry city, Center city, 
Theodosia village: Sundown village, 
Tightwad village: Calhoun city, 
Tina town: Bogard city, Bosworth city, Hale city, 
Tindall town: Spickard city, Trenton city, Brimson village, 
Tipton city: Syracuse city, Clarksburg city, 
Town and Country city: Country Life Acres village, 
Tracy city: Platte City city, Weston city, 
Trenton city: Tindall town, 
Trimble city: Edgerton city, 
Triplett city: Brunswick city, Mendon town, 
Troy city: Moscow Mills city, Cave town, 
Truesdale city: Warrenton city, Wright City city, 
Truxton village: Bellflower city, Hawk Point city, 
Turney village: Lathrop city, Osborn city, 
Tuscumbia town: Eugene town, Brumley town, 
Twin Bridges town: Lebanon city, 
Twin Oaks village: Peerless Park village, Manchester city, 
Umber View Heights village: Stockton city, Arcola village, 
Union city: St. Clair city, Washington city, 
Union Star town: King City city, 
Unionville city: Pollock village, 
Unity Village village: Lee's Summit city, Raytown city, 
University City city: Clayton city, Hanley Hills village, 
Uplands Park village: Beverly Hills city, 
Urbana city: Louisburg village, Preston town, 
Urich city: Hartwell village, Creighton city, Blairstown city, 
Utica village: Chillicothe city, Mooresville village, 
Valley Park city: Peerless Park village, Fenton city, 
Van Buren town: Ellington city, Grandin city, 
Vandalia city: Farber city, Curryville city, 
Vandiver village: Mexico city, Benton City town, 
Vanduser village: Hay-Wood City village, Bell City city, 
Velda Village city: Beverly Hills city, 
Velda Village Hills village: Beverly Hills city, 
Verona town: Aurora city, Freistatt town, 
Versailles city: Gravois Mills village, Stover city, 
Viburnum town: Bunker city, 
Vienna city: Argyle town, 
Village of Four Seasons town: Sunrise Beach village, Lake Ozark city, 
Villa Ridge CDP: Gray Summit CDP, 
Vinita Park city: Charlack city, Vinita Terrace village, 
Vinita Terrace village: Hanley Hills village, Vinita Park city, 
Vista village: Osceola city, Gerster town, 
Waco town: Asbury city, Carl Junction city, 
Wakenda town: Carrollton city, Grand Pass town, 
Walker city: Harwood town, Nevada city, 
Walnut Grove city: Ash Grove city, Aldrich village, 
Wardell town: North Wardell village, 
Wardsville town: Jefferson City city, Taos city, St. Thomas town, 
Warrensburg city: Centerview town, 
Warrenton city: Truesdale city, 
Warsaw city: Lincoln city, 
Warson Woods city: Glendale city, Huntleigh city, 
Washburn city: Exeter city, Seligman city, 
Washington city: Marthasville city, Union city, Augusta city, 
Watson village: Phelps City town, 
Waverly city: Grand Pass town, 
Wayland city: Alexandria city, Kahoka city, 
Waynesville city: St. Robert city, Crocker city, 
Weatherby town: Winston town, 
Weatherby Lake city: Parkville city, 
Weaubleau city: Gerster town, Flemington village, 
Webb City city: Carterville city, Oakland Park village, 
Webster Groves city: Glendale city, 
Weldon Spring town: Cottleville town, Weldon Spring Heights town, Chesterfield city, 
Weldon Spring Heights town: Weldon Spring town, 
Wellington city: Camden city, 
Wellston city: Hillsdale village, 
Wellsville city: Martinsburg town, Montgomery City city, 
Wentworth village: Pierce City city, Sarcoxie city, Ritchey town, 
Wentzville city: Flint Hill village, Foristell city, New Melle village, 
Westboro city: Tarkio city, 
West Line village: Cleveland town, Freeman city, 
Weston city: Iatan village, Tracy city, 
Westphalia city: Taos city, Linn city, 
West Plains city: Brandsville city, Willow Springs city, Bakersfield village, 
Westwood village: Creve Coeur city, Crystal Lake Park city, 
Wheatland city: Hermitage city, 
Wheaton city: Fairview town, 
Wheeling city: Meadville city, 
Whiteman AFB CDP: Knob Noster city, 
Whiteside village: Eolia village, Silex village, 
Whitewater town: Allenville village, 
Wilbur Park village: Affton CDP, 
Willard city: Brookline village, 
Williamsville city: Mill Spring village, Greenville city, 
Willow Springs city: Cabool city, West Plains city, 
Wilson City town: Wyatt city, Charleston city, 
Winchester city: Manchester city, Ballwin city, 
Windsor city: Calhoun city, Green Ridge town, 
Winfield city: Foley city, Old Monroe city, 
Winona city: Eminence city, Birch Tree city, 
Winston town: Altamont town, Kidder city, Weatherby town, 
Woods Heights city: Crystal Lakes village, Rayville village, 
Woodson Terrace city: Edmundson village, Berkeley city, 
Wooldridge town: Rocheport city, Lupus town, Prairie Home city, 
Worth town: Gentry village, Grant City town, 
Worthington village: Livonia village, 
Wright City city: Foristell city, Truesdale city, 
Wyaconda city: Luray town, 
Wyatt city: Wilson City town, 
Zalma village: Advance city, Glenallen town, 
