2
Adrian city: Archie city, Passaic town, 
Advance city: Bell City city, Zalma village, 
Affton CDP: Grantwood Village town, Lakeshire city, Marlborough village, St. George city, 
Agency town: Easton city, St. Joseph city, 
Airport Drive village: Webb City city, Carl Junction city, 
Alba city: Oronogo city, Carytown city, Purcell city, 
Albany city: Darlington village, Gentry village, New Hampton city, 
Aldrich village: Walnut Grove city, Fair Play city, 
Alexandria city: Wayland city, 
Allendale town: Grant City town, Denver village, 
Allenville village: Delta city, Gordonville town, Whitewater town, 
Alma city: Corder city, Blackburn city, Concordia city, 
Altamont town: Winston town, Gallatin city, 
Altenburg city: Frohna city, 
Alton city: Thayer city, 
Amazonia town: Country Club village, Savannah city, 
Amity town: Clarksdale city, Maysville city, 
Amoret city: Foster town, Amsterdam city, 
Amsterdam city: Amoret city, Merwin town, 
Anderson city: Goodman town, Lanagan town, 
Annada town: Paynesville village, Elsberry city, 
Annapolis city: Arcadia city, Des Arc village, 
Anniston town: Charleston city, East Prairie city, 
Appleton City city: Montrose city, Rockville city, 
Arbela town: South Gorin town, Granger town, Memphis city, 
Arbyrd city: Senath city, Cardwell city, 
Arcadia city: Annapolis city, Ironton city, 
Archie city: Adrian city, Harrisonville city, 
Arcola village: Jerico Springs village, Greenfield city, Umber View Heights village, 
Argyle town: Meta city, Freeburg village, 
Arkoe town: Barnard city, Maryville city, 
Armstrong city: Glasgow city, Fayette city, 
Arnold city: Oakville CDP, Imperial CDP, 
Arrow Rock town: Blackwater city, 
Asbury city: Waco town, 
Ashburn town: Frankford city, 
Ash Grove city: Everton city, Halltown town, Walnut Grove city, 
Ashland city: Hartsburg town, 
Atlanta city: La Plata city, 
Augusta city: Villa Ridge CDP, 
Aullville village: Higginsville city, Corder city, 
Aurora city: Marionville city, Verona town, 
Auxvasse city: Vandiver village, Kingdom City village, 
Ava city: Mansfield city, 
Avilla town: Reeds town, La Russell city, 
Avondale city: Randolph village, North Kansas City city, Oaks village, 
Bagnell town: Eldon city, Lakeland town, 
Baker village: Penermon village, Canalou city, 
Bakersfield village: West Plains city, Gainesville city, 
Baldwin Park village: Strasburg town, Pleasant Hill city, 
Ballwin city: Ellisville city, Winchester city, 
Baring city: Edina city, Rutledge town, 
Barnard city: Arkoe town, Bolckow city, Guilford town, 
Barnett city: Eldon city, 
Barnhart CDP: Imperial CDP, Pevely city, 
Bates City village: Oak Grove city, Odessa city, 
Battlefield town: Brookline village, Nixa city, Springfield city, 
Bella Villa city: St. George city, Lemay CDP, 
Bell City city: Advance city, Vanduser village, 
Belle city: Freeburg village, Bland city, 
Bellefontaine Neighbors city: Moline Acres city, Riverview village, 
Bellerive village: Bel-Nor village, Cool Valley city, Normandy city, 
Bellflower city: High Hill city, Middletown town, Truxton village, 
Bel-Nor village: Bellerive village, Greendale city, Bel-Ridge village, 
Bel-Ridge village: Bel-Nor village, 
Belton city: Raymore city, Grandview city, 
Benton city: Morley city, Kelso town, Lambert village, 
Benton City town: Rush Hill town, Martinsburg town, Vandiver village, 
Berger city: Hermann city, New Haven city, 
Berkeley city: Woodson Terrace city, Kinloch city, 
Bernie city: Dexter city, Malden city, 
Bertrand city: Miner city, Diehlstadt town, 
Bethany city: Coffey town, Ridgeway city, 
Bethel town: Leonard town, Newark town, Shelbyville city, 
Beverly Hills city: Normandy city, Glen Echo Park village, Hillsdale village, Northwoods city, Velda Village city, 
Bevier city: Callao city, Macon city, 
Bigelow village: Mound City city, Big Lake village, Craig city, 
Big Lake village: Bigelow village, Fortescue town, 
Billings city: Halltown town, Clever city, Marionville city, 
Birch Tree city: Mountain View city, Winona city, 
Birmingham village: Sugar Creek city, Claycomo village, Randolph village, 
Bismarck city: Irondale city, Iron Mountain Lake city, 
Blackburn city: Alma city, Mount Leonard town, 
Black Jack city: Castle Point CDP, 
Blackwater city: Arrow Rock town, Pilot Grove city, Nelson city, 
Blairstown city: Urich city, Chilhowee town, 
Bland city: Belle city, Owensville city, 
Blodgett town: Diehlstadt town, Hay-Wood City village, 
Bloomfield city: Dexter city, 
Bloomsdale city: Ste. Genevieve city, Rocky Ridge village, 
Blue Eye town: Table Rock village, 
Blue Springs city: Lake Lotawana city, Grain Valley city, Lake Tapawingo city, 
Blythedale village: Ridgeway city, Cainsville city, Eagleville town, 
Bogard city: Carrollton city, Tina town, 
Bolckow city: Barnard city, Rosendale city, 
Bolivar city: Morrisville town, 
Bonne Terre city: De Soto city, Desloge city, 
Boonville city: Franklin city, 
Bosworth city: Tina town, 
Bourbon city: St. Cloud village, Leasburg village, 
Bowling Green city: Curryville city, Tarrants village, 
Bragg City town: Pascola town, Kennett city, 
Brandsville city: West Plains city, Koshkonong town, 
Branson city: Table Rock village, Hollister city, Merriam Woods village, 
Brashear city: Gibbs town, Hurdland city, 
Braymer city: Cowgill city, Ludlow town, 
Breckenridge city: Mooresville village, Lock Springs town, 
Breckenridge Hills village: St. John city, Edmundson village, Overland city, St. Ann city, 
Brentwood city: Maplewood city, Rock Hill city, 
Bridgeton city: St. Ann city, Champ village, 
Brimson village: Gilman City city, Tindall town, 
Bronaugh city: Moundville town, Liberal city, 
Brookfield city: Rothville village, Laclede city, 
Brookline village: Battlefield town, Republic city, Willard city, 
Brooklyn Heights village: Carthage city, Carterville city, 
Browning city: Purdin city, Milan city, 
Brownington town: Deepwater city, Lowry City city, 
Brumley town: Tuscumbia town, 
Brunswick city: Triplett city, Dalton town, De Witt city, 
Bucklin city: Marceline city, New Cambria town, 
Buckner city: Grain Valley city, Levasy city, Sibley village, 
Buffalo city: Halfway village, Louisburg village, 
Bunceton city: Tipton city, Pilot Grove city, 
Bunker city: Centerville city, Viburnum town, 
Burgess town: Liberal city, Mindenmines city, 
Burlington Junction city: Quitman town, Clearmont city, 
Butler city: Passaic town, 
Butterfield village: Purdy city, Cassville city, 
Byrnes Mill city: High Ridge CDP, Eureka city, Scotsdale town, 
Cabool city: Mountain Grove city, Willow Springs city, 
Cainsville city: Blythedale village, Mount Moriah town, 
Cairo village: Moberly city, Jacksonville village, 
Caledonia village: Irondale city, 
Calhoun city: Windsor city, Leeton city, Tightwad village, 
California city: Clarksburg city, Centertown town, Jamestown town, 
Callao city: Bevier city, New Cambria town, 
Calverton Park village: Ferguson city, Florissant city, 
Camden city: Fleming city, Henrietta city, Wellington city, 
Camden Point city: Ridgely town, Dearborn city, Platte City city, 
Camdenton city: Linn Creek city, 
Cameron city: Osborn city, 
Campbell city: Malden city, Holcomb city, 
Canalou city: Baker village, Matthews city, Morehouse city, 
Canton city: Monticello town, La Grange city, 
Cape Girardeau city: Scott City city, 
Cardwell city: Arbyrd city, 
Carl Junction city: Airport Drive village, Waco town, 
Carrollton city: Bogard city, Wakenda town, 
Carterville city: Brooklyn Heights village, Webb City city, 
Carthage city: Brooklyn Heights village, Fidelity town, 
Caruthersville city: Hayti city, 
Carytown city: Alba city, Jasper city, 
Cassville city: Butterfield village, Chain-O-Lakes village, Exeter city, 
Castle Point CDP: Black Jack city, Dellwood city, Moline Acres city, 
Catron town: Parma city, North Lilbourn village, 
Cave town: Hawk Point city, Silex village, Troy city, 
Cedar Hill CDP: Scotsdale town, Cedar Hill Lakes village, 
Cedar Hill Lakes village: Cedar Hill CDP, 
Center city: The Landing village, New London city, 
Centertown town: California city, St. Martins city, 
Centerview town: Holden city, Warrensburg city, 
Centerville city: Bunker city, Ellington city, 
Centralia city: Hallsville city, 
Chaffee city: Oran city, Delta city, 
Chain-O-Lakes village: Cassville city, Emerald Beach village, 
Chamois city: Morrison city, Mokane city, 
Champ village: Bridgeton city, Maryland Heights city, 
Charlack city: Vinita Park city, St. John city, Sycamore Hills village, 
Charleston city: Anniston town, Diehlstadt town, Wilson City town, 
Chesterfield city: Weldon Spring town, Clarkson Valley city, 
Chilhowee town: Blairstown city, 
Chillicothe city: Utica village, Chula city, 
Chula city: Chillicothe city, Laredo city, 
Clarence city: Leonard town, 
Clark city: Renick village, Sturgeon city, 
Clarksburg city: California city, Tipton city, 
Clarksdale city: Amity town, Easton city, Cosby town, Stewartsville city, 
Clarkson Valley city: Chesterfield city, Ellisville city, 
Clarksville city: Paynesville village, 
Clarkton city: Holcomb city, Gideon city, 
Claycomo village: Birmingham village, Pleasant Valley city, 
Clayton city: Richmond Heights city, University City city, 
Clearmont city: Burlington Junction city, Elmo city, 
Cleveland town: West Line village, 
Clever city: Billings city, Hurley city, Republic city, 
Cliff Village village: Dennis Acres village, Redings Mill village, Shoal Creek Drive village, 
Clifton Hill city: Salisbury city, Huntsville city, 
Climax Springs village: Cross Timbers city, Macks Creek city, 
Clinton city: La Due village, Deepwater city, 
Clyde village: Conception Junction town, Ravenwood town, Stanberry city, 
Cobalt City village: Marquand city, Fredericktown city, 
Coffey town: Bethany city, Jameson town, Gilman City city, Pattonsburg city, 
Cole Camp city: Ionia town, 
Collins village: Gerster town, 
Columbia city: Lupus town, 
Commerce town: Scott City city, 
Conception Junction town: Clyde village, Guilford town, 
Concord CDP: Lakeshire city, Sappington CDP, 
Concordia city: Alma city, Emma city, 
Conway city: Niangua city, Phillipsburg town, 
Cool Valley city: Bellerive village, Ferguson city, 
Cooter city: Steele city, 
Corder city: Alma city, Aullville village, Dover town, 
Corning town: Craig city, Fairfax city, 
Cosby town: Clarksdale city, 
Cottleville town: O'Fallon city, St. Peters city, Weldon Spring town, 
Country Club village: Amazonia town, St. Joseph city, 
Country Club Hills city: Norwood Court town, Flordell Hills city, 
Country Life Acres village: Crystal Lake Park city, Town and Country city, 
Cowgill city: Braymer city, Polo city, 
Craig city: Corning town, Bigelow village, 
Crane city: Hurley city, 
Creighton city: Garden City city, Urich city, 
Crestwood city: Sunset Hills city, Grantwood Village town, Oakland city, 
Creve Coeur city: Westwood village, 
Crocker city: Iberia city, Dixon city, Richland city, Waynesville city, 
Cross Timbers city: Climax Springs village, Preston town, 
Crystal City city: Herculaneum city, Festus city, 
Crystal Lake Park city: Country Life Acres village, Huntleigh city, Des Peres city, Frontenac city, 
Crystal Lakes village: Woods Heights city, Homestead village, 
Cuba city: Leasburg village, Steelville city, 
Curryville city: Bowling Green city, Frankford city, Vandalia city, 
Dadeville village: Everton city, 
Dalton town: Brunswick city, Gilliam town, Keytesville city, 
Dardenne Prairie town: Lake St. Louis city, O'Fallon city, 
Darlington village: Albany city, Ford City town, 
Dearborn city: Camden Point city, 
Deepwater city: Brownington town, Clinton city, 
Deerfield village: Moundville town, Richards town, 
De Kalb town: Rushville town, 
Dellwood city: Castle Point CDP, Ferguson city, 
Delta city: Allenville village, Chaffee city, 
Dennis Acres village: Cliff Village village, Joplin city, Leawood village, 
Denver village: Allendale town, 
Des Arc village: Annapolis city, Piedmont city, 
Desloge city: Bonne Terre city, Flat River city, 
De Soto city: Bonne Terre city, Olympian Village city, Hillsboro city, 
Des Peres city: Crystal Lake Park city, Kirkwood city, 
De Witt city: Brunswick city, Miami city, 
Dexter city: Bernie city, Bloomfield city, Dudley city, Essex city, 
Diamond town: Granby city, Fidelity town, 
Diehlstadt town: Blodgett town, Charleston city, Bertrand city, 
Diggins village: Fordland city, Marshfield city, Seymour city, 
Dixon city: Crocker city, Doolittle city, 
Doniphan city: Grandin city, Naylor city, 
Doolittle city: Dixon city, Newburg city, Rolla city, 
Dover town: Corder city, Norborne city, 
Downing city: Lancaster city, 
Drexel city: Merwin town, 
Dudley city: Dexter city, Fisk city, Puxico city, 
Duenweg city: Duquesne village, 
Duquesne village: Duenweg city, Oakland Park village, 
Eagleville town: Blythedale village, 
East Lynne town: Harrisonville city, Gunn City village, 
Easton city: Agency town, Clarksdale city, Gower city, 
East Prairie city: Anniston town, 
Edgar Springs city: Newburg city, Licking city, Salem city, 
Edgerton city: Ridgely town, Gower city, Trimble city, 
Edina city: Baring city, Hurdland city, Novelty town, 
Edmundson village: Breckenridge Hills village, Woodson Terrace city, 
Eldon city: Bagnell town, Barnett city, Olean town, 
El Dorado Springs city: Harwood town, 
Ellington city: Centerville city, Van Buren town, 
Ellisville city: Ballwin city, Clarkson Valley city, 
Ellsinore town: Mill Spring village, Grandin city, 
Elmer city: Ethel town, South Gifford village, 
Elmira village: Lawson city, Polo city, 
Elmo city: Clearmont city, 
Elsberry city: Annada town, 
Elvins city: Flat River city, Leadwood city, Rivermines village, 
Emerald Beach village: Chain-O-Lakes village, 
Eminence city: Winona city, 
Emma city: Concordia city, Sweet Springs city, 
Eolia village: Whiteside village, Paynesville village, 
Essex city: Dexter city, Penermon village, 
Esther city: Flat River city, Leadington city, 
Ethel town: Elmer city, New Cambria town, 
Eugene town: Olean town, Tuscumbia town, 
Eureka city: Byrnes Mill city, Pacific city, 
Everton city: Ash Grove city, Dadeville village, South Greenfield village, 
Ewing city: Monticello town, 
Excelsior Estates village: Homestead village, Lawson city, 
Excelsior Springs city: Homestead village, Prathersville village, 
Exeter city: Cassville city, Washburn city, 
Fairfax city: Corning town, Tarkio city, 
Fair Grove city: Pleasant Hope city, Strafford city, 
Fair Play city: Aldrich village, 
Fairview town: Stark City town, Wheaton city, 
Farber city: Vandalia city, Laddonia city, 
Farley village: Platte City city, 
Farmington city: Leadington city, 
Fayette city: Armstrong city, New Franklin city, 
Fenton city: Valley Park city, Sunset Hills city, 
Ferguson city: Calverton Park village, Dellwood city, Cool Valley city, 
Ferrelview village: Weatherby Lake city, Smithville city, 
Festus city: Crystal City city, Olympian Village city, 
Fidelity town: Carthage city, Diamond town, 
Fillmore city: Rosendale city, Graham town, 
Fisk city: Dudley city, Poplar Bluff city, Qulin city, 
Flat River city: Elvins city, Esther city, Desloge city, 
Fleming city: Camden city, Napoleon city, Orrick city, 
Flemington village: Weaubleau city, Humansville city, 
Flint Hill village: Moscow Mills city, Josephville village, Wentzville city, 
Flordell Hills city: Country Club Hills city, Jennings city, 
Florida village: Stoutsville village, 
Florissant city: Calverton Park village, Hazelwood city, Portage Des Sioux city, 
Foley city: Winfield city, 
Ford City town: Darlington village, Stanberry city, King City city, 
Fordland city: Diggins village, Rogersville town, 
Forest City city: Fortescue town, Oregon city, 
Foristell city: Wentzville city, Wright City city, 
Forsyth city: Rockaway Beach city, Taneyville village, 
Fortescue town: Forest City city, Big Lake village, 
Fort Leonard Wood CDP: St. Robert city, 
Foster town: Amoret city, Hume town, 
Frankford city: Ashburn town, Curryville city, New London city, 
Franklin city: Boonville city, New Franklin city, 
Fredericktown city: Cobalt City village, Junction City village, 
Freeburg village: Belle city, Argyle town, Vienna city, 
Freeman city: Lake Annette village, 
Freistatt town: Verona town, Hoberg village, Monett city, Stotts City city, 
Fremont Hills city: Nixa city, Ozark city, 
Frohna city: Altenburg city, Old Appleton town, 
Frontenac city: Crystal Lake Park city, Westwood village, 
Fulton city: Kingdom City village, 
Gainesville city: Bakersfield village, Sundown village, 
Galena city: Hurley city, Reeds Spring city, 
Gallatin city: Altamont town, Jameson town, 
Galt city: Laredo city, Humphreys town, 
Garden City city: Creighton city, Gunn City village, 
Gasconade city: Rhineland town, Morrison city, 
Gentry village: Albany city, Worth town, 
Gerald city: Rosebud city, Leslie village, 
Gerster town: Collins village, Vista village, Weaubleau city, 
Gibbs town: Brashear city, La Plata city, 
Gideon city: Clarkton city, North Wardell village, Tallapoosa city, 
Gilliam town: Dalton town, Glasgow city, Slater city, 
Gilman City city: Brimson village, Coffey town, 
Gladstone city: Oakview village, 
Glasgow city: Armstrong city, Gilliam town, 
Glasgow Village CDP: Riverview village, Spanish Lake CDP, 
Glenaire village: Pleasant Valley city, Liberty city, 
Glenallen town: Zalma village, Marble Hill city, Marquand city, 
Glendale city: Oakland city, Warson Woods city, 
Glen Echo Park village: Beverly Hills city, 
Glenwood village: Queen City city, Lancaster city, Livonia village, 
Golden City city: Lockwood city, 
Goodman town: Anderson city, Neosho city, 
Gordonville town: Allenville village, Jackson city, 
Gower city: Easton city, Edgerton city, 
Graham town: Fillmore city, Maitland city, 
Grain Valley city: Buckner city, Blue Springs city, Oak Grove city, 
Granby city: Diamond town, Ritchey town, Neosho city, 
Grandin city: Doniphan city, Ellsinore town, Van Buren town, 
Grand Pass town: Malta Bend town, Waverly city, 
Grandview city: Belton city, 
Granger town: Arbela town, Luray town, 
Grant City town: Allendale town, Worth town, 
Grantwood Village town: Affton CDP, Crestwood city, 
Gravois Mills village: Laurie village, Versailles city, 
Gray Summit CDP: Pacific city, Villa Ridge CDP, 
Greencastle city: Green City city, 
Green City city: Greencastle city, Pollock village, 
Greendale city: Bel-Nor village, Hanley Hills village, Pagedale city, 
Greenfield city: Arcola village, South Greenfield village, 
Green Ridge town: La Monte city, Ionia town, Windsor city, 
Greentop city: Kirksville city, Queen City city, 
Greenville city: Williamsville city, 
Greenwood city: Pleasant Hill city, Lake Lotawana city, Lake Winnebago city, Lee's Summit city, 
Guilford town: Conception Junction town, Barnard city, 
Gunn City village: Garden City city, East Lynne town, La Tour town, Strasburg town, 
Hale city: Tina town, Sumner town, 
Halfway village: Buffalo city, Pleasant Hope city, 
Hallsville city: Centralia city, Sturgeon city, 
Halltown town: Billings city, Ash Grove city, 
Hamilton city: Kingston city, Kidder city, 
Hanley Hills village: Greendale city, University City city, Vinita Terrace village, 
Hannibal city: New London city, Palmyra city, 
Hardin city: Lexington city, 
Harris town: Osgood town, Newtown town, 
Harrisburg town: Higbee city, 
Harrisonville city: East Lynne town, Archie city, 
Hartsburg town: Ashland city, St. Martins city, 
Hartville city: Mansfield city, 
Hartwell village: Urich city, La Due village, 
Harwood town: El Dorado Springs city, Schell City city, Walker city, 
Hawk Point city: Cave town, Truxton village, 
Hayti city: Caruthersville city, Hayti Heights city, 
Hayti Heights city: Hayti city, Pascola town, Steele city, 
Hayward town: Portageville city, 
Hay-Wood City village: Blodgett town, Morley city, Vanduser village, 
Hazelwood city: Florissant city, 
Henrietta city: Camden city, Lexington city, Richmond city, 
Herculaneum city: Crystal City city, Pevely city, 
Hermann city: Berger city, McKittrick town, 
Hermitage city: Preston town, Wheatland city, 
Higbee city: Harrisburg town, Renick village, 
Higginsville city: Aullville village, Mayview city, 
High Hill city: Bellflower city, New Florence city, Jonesburg city, McKittrick town, 
High Ridge CDP: Byrnes Mill city, Parkdale town, 
Hillsboro city: De Soto city, 
Hillsdale village: Beverly Hills city, Wellston city, 
Hoberg village: Freistatt town, Mount Vernon city, 
Holcomb city: Clarkton city, Campbell city, 
Holden city: Centerview town, Kingsville city, 
Holland town: Steele city, 
Holliday village: Paris city, Madison city, 
Hollister city: Branson city, 
Holt city: Kearney city, Lathrop city, 
Holts Summit city: Jefferson City city, Lake Mykee Town village, 
Homestead village: Excelsior Estates village, Excelsior Springs city, Crystal Lakes village, 
Homestown city: Wardell town, Pascola town, 
Hopkins city: Pickering town, 
Horine CDP: Pevely city, 
Hornersville city: Senath city, 
Houston city: Raymondville town, 
Houstonia city: Sweet Springs city, Hughesville village, La Monte city, 
Houston Lake city: Northmoor city, Lake Waukomis city, Riverside city, 
Howardville city: Lilbourn city, Marston city, New Madrid city, 
Hughesville village: Houstonia city, Sedalia city, 
Humansville city: Flemington village, 
Hume town: Foster town, Stotesbury town, 
Humphreys town: Galt city, Osgood town, 
Hunnewell city: Shelbina city, Monroe City city, Stoutsville village, 
Huntleigh city: Crystal Lake Park city, Warson Woods city, 
Huntsville city: Clifton Hill city, Moberly city, 
Hurdland city: Edina city, Brashear city, 
Hurley city: Crane city, Galena city, Clever city, 
Iatan village: Weston city, Lewis and Clark Village town, 
Iberia city: Crocker city, St. Elizabeth town, 
Imperial CDP: Barnhart CDP, Arnold city, Kimmswick city, 
Independence city: Lake Tapawingo city, Sugar Creek city, 
Indian Point village: Lakeview city, Kimberling City city, Table Rock village, 
Ionia town: Cole Camp city, Green Ridge town, Lincoln city, 
Irondale city: Bismarck city, Caledonia village, Leadwood city, Mineral Point town, 
Iron Gates village: Shoal Creek Drive village, 
Iron Mountain Lake city: Bismarck city, Pilot Knob city, 
Ironton city: Arcadia city, Pilot Knob city, 
Jackson city: Gordonville town, Pocahontas town, 
Jacksonville village: Cairo village, 
Jameson town: Coffey town, Gallatin city, 
Jamesport city: Lock Springs town, 
Jamestown town: California city, Lupus town, 
Jasper city: Carytown city, 
Jefferson City city: Holts Summit city, St. Martins city, Wardsville town, 
Jennings city: Flordell Hills city, 
Jerico Springs village: Arcola village, Milford village, 
Jonesburg city: High Hill city, 
Joplin city: Dennis Acres village, Oakland Park village, 
Josephville village: Flint Hill village, Lake St. Louis city, St. Paul village, 
Junction City village: Fredericktown city, 
Kahoka city: Luray town, Revere town, 
Kansas City city: North Kansas City city, 
Kearney city: Holt city, Mosby city, 
Kelso town: Benton city, Scott City city, 
Kennett city: Bragg City town, Senath city, 
Keytesville city: Dalton town, Salisbury city, 
Kidder city: Hamilton city, Winston town, 
Kimberling City city: Indian Point village, 
Kimmswick city: Imperial CDP, 
King City city: Ford City town, Union Star town, 
Kingdom City village: Fulton city, Auxvasse city, 
Kingston city: Hamilton city, Polo city, 
Kingsville city: Holden city, Strasburg town, 
Kinloch city: Berkeley city, 
Kirksville city: Greentop city, Millard village, Novinger city, 
Kirkwood city: Des Peres city, 
Knob Noster city: La Monte city, Whiteman AFB CDP, 
Knox City city: La Belle city, 
Koshkonong town: Brandsville city, Thayer city, 
La Belle city: Knox City city, Newark town, Lewistown town, 
Laclede city: Brookfield city, Linneus city, Meadville city, 
Laddonia city: Farber city, Rush Hill town, 
La Due village: Clinton city, Hartwell village, Montrose city, 
Ladue city: Rock Hill city, 
La Grange city: Canton city, 
Lake Annette village: Freeman city, Peculiar city, West Line village, 
Lakeland town: Bagnell town, Lakeview village, 
Lake Lotawana city: Blue Springs city, Greenwood city, Lone Jack village, 
Lake Mykee Town village: Holts Summit city, New Bloomfield city, 
Lake Ozark city: Lakeside city, Osage Beach city, Village of Four Seasons town, 
Lake St. Louis city: Dardenne Prairie town, Josephville village, 
Lakeshire city: Concord CDP, Affton CDP, 
Lakeside city: Lake Ozark city, Lakeview village, 
Lake Tapawingo city: Independence city, Blue Springs city, 
Lakeview village: Lakeside city, Lakeland town, 
Lakeview city: Indian Point village, Reeds Spring city, 
Lake Waukomis city: Houston Lake city, Platte Woods city, 
Lake Winnebago city: Greenwood city, Raymore city, 
Lamar city: Milford village, Lamar Heights village, 
Lamar Heights village: Lamar city, 
Lambert village: Benton city, 
La Monte city: Green Ridge town, Knob Noster city, Houstonia city, 
Lanagan town: Anderson city, Noel city, Pineville town, 
Lancaster city: Downing city, Glenwood village, 
La Plata city: Atlanta city, Gibbs town, Millard village, 
Laredo city: Galt city, Chula city, 
La Russell city: Avilla town, 
Lathrop city: Holt city, Plattsburg city, Turney village, 
La Tour town: Gunn City village, 
Laurie village: Gravois Mills village, Sunrise Beach village, 
Lawson city: Elmira village, Excelsior Estates village, 
Leadington city: Farmington city, Esther city, 
Leadwood city: Irondale city, Elvins city, 
Leasburg village: Cuba city, Bourbon city, 
Leawood village: Dennis Acres village, Saginaw village, Shoal Creek Estates town, 
Lebanon city: Phillipsburg town, Twin Bridges town, 
Lee's Summit city: Greenwood city, Unity Village village, 
Leeton city: Calhoun city, 
Lemay CDP: Bella Villa city, 
Leonard town: Bethel town, Clarence city, Novelty town, 
Leslie village: Gerald city, Oak Grove village, 
Levasy city: Buckner city, Napoleon city, 
Lewis and Clark Village town: Iatan village, Rushville town, 
Lewistown town: La Belle city, Monticello town, 
Lexington city: Hardin city, Henrietta city, 
Liberal city: Burgess town, Bronaugh city, 
Liberty city: Glenaire village, 
Licking city: Edgar Springs city, Raymondville town, 
Lilbourn city: Howardville city, North Lilbourn village, 
Lincoln city: Ionia town, Warsaw city, 
Linn city: Westphalia city, 
Linn Creek city: Camdenton city, Osage Beach city, 
Linneus city: Laclede city, Purdin city, 
Lithium village: Perryville city, St. Mary city, 
Livonia village: Glenwood village, Worthington village, 
Lock Springs town: Jamesport city, Breckenridge city, 
Lockwood city: Golden City city, South Greenfield village, 
Lohman town: St. Martins city, Russellville city, 
Lone Jack village: Lake Lotawana city, 
Longtown town: Old Appleton town, Perryville city, 
Louisburg village: Buffalo city, Urbana city, 
Louisiana city: Tarrants village, 
Lowry City city: Brownington town, Osceola city, 
Lucerne village: Newtown town, Powersville village, 
Ludlow town: Braymer city, Mooresville village, 
Lupus town: Columbia city, Jamestown town, Wooldridge town, 
Luray town: Kahoka city, Granger town, Wyaconda city, 
McFall city: Pattonsburg city, 
Mac Kenzie village: Marlborough village, Shrewsbury city, 
McKittrick town: Hermann city, High Hill city, Rhineland town, 
Macks Creek city: Climax Springs village, 
Macon city: Bevier city, 
Madison city: Holliday village, 
Maitland city: Graham town, Mound City city, Skidmore city, 
Malden city: Campbell city, Bernie city, 
Malta Bend town: Grand Pass town, Mount Leonard town, Wakenda town, 
Manchester city: Winchester city, Twin Oaks village, 
Mansfield city: Ava city, Hartville city, Seymour city, Norwood city, 
Maplewood city: Brentwood city, Shrewsbury city, Richmond Heights city, 
Marble Hill city: Glenallen town, 
Marceline city: Bucklin city, Rothville village, 
Marionville city: Aurora city, Billings city, 
Marlborough village: Mac Kenzie village, Affton CDP, Webster Groves city, 
Marquand city: Cobalt City village, Glenallen town, 
Marshall city: Slater city, 
Marshfield city: Diggins village, Niangua city, 
Marston city: Howardville city, Portageville city, 
Marthasville city: Washington city, 
Martinsburg town: Benton City town, Wellsville city, 
Maryland Heights city: Champ village, St. Charles city, 
Maryville city: Arkoe town, Pickering town, 
Matthews city: Canalou city, 
Maysville city: Amity town, 
Mayview city: Higginsville city, Odessa city, 
Meadville city: Laclede city, Wheeling city, 
Mehlville CDP: St. George city, Oakville CDP, 
Memphis city: Arbela town, 
Mendon town: Sumner town, Rothville village, Triplett city, 
Mercer town: Princeton city, South Lineville town, 
Merriam Woods village: Branson city, Rockaway Beach city, 
Merwin town: Drexel city, Amsterdam city, 
Meta city: Argyle town, St. Thomas town, St. Elizabeth town, 
Metz town: Stotesbury town, Rich Hill city, 
Mexico city: Vandiver village, 
Miami city: De Witt city, 
Middletown town: Bellflower city, 
Milan city: Browning city, Pollock village, 
Milford village: Jerico Springs village, Lamar city, Sheldon city, 
Millard village: Kirksville city, La Plata city, South Gifford village, 
Miller city: Mount Vernon city, 
Mill Spring village: Ellsinore town, Piedmont city, Williamsville city, 
Milo town: Nevada city, Sheldon city, 
Mindenmines city: Burgess town, 
Miner city: Bertrand city, Sikeston city, 
Mineral Point town: Irondale city, Potosi city, 
Missouri City city: Prathersville village, 
Moberly city: Cairo village, Huntsville city, Renick village, 
Mokane city: Chamois city, 
Moline Acres city: Bellefontaine Neighbors city, Castle Point CDP, 
Monett city: Freistatt town, Pierce City city, Purdy city, 
Monroe City city: Hunnewell city, The Landing village, 
Montgomery City city: Wellsville city, New Florence city, 
Monticello town: Canton city, Ewing city, Lewistown town, 
Montrose city: Appleton City city, La Due village, 
Mooresville village: Breckenridge city, Ludlow town, Utica village, 
Morehouse city: Canalou city, Sikeston city, 
Morley city: Benton city, Hay-Wood City village, Oran city, 
Morrison city: Chamois city, Gasconade city, 
Morrisville town: Bolivar city, Walnut Grove city, Pleasant Hope city, 
Mosby city: Kearney city, Prathersville village, 
Moscow Mills city: Flint Hill village, Troy city, 
Mound City city: Bigelow village, Maitland city, 
Moundville town: Bronaugh city, Deerfield village, Nevada city, 
Mountain Grove city: Cabool city, Norwood city, 
Mountain View city: Birch Tree city, Summersville city, 
Mount Leonard town: Malta Bend town, Blackburn city, 
Mount Moriah town: Cainsville city, 
Mount Vernon city: Miller city, Hoberg village, 
Murphy CDP: Peerless Park village, Parkdale town, 
Napoleon city: Fleming city, Levasy city, 
Naylor city: Doniphan city, Neelyville city, 
Neck City city: Purcell city, 
Neelyville city: Naylor city, Poplar Bluff city, 
Nelson city: Blackwater city, 
Neosho city: Goodman town, Granby city, 
Nevada city: Milo town, Moundville town, Walker city, 
Newark town: La Belle city, Bethel town, 
New Bloomfield city: Lake Mykee Town village, 
Newburg city: Edgar Springs city, Doolittle city, 
New Cambria town: Callao city, Ethel town, Bucklin city, 
New Florence city: High Hill city, Montgomery City city, 
New Franklin city: Franklin city, Fayette city, 
New Hampton city: Albany city, 
New Haven city: Berger city, 
New London city: Frankford city, Hannibal city, Center city, 
New Madrid city: Howardville city, 
New Melle village: Wentzville city, 
Newtonia town: Ritchey town, Stark City town, 
Newtown town: Lucerne village, Harris town, 
Niangua city: Conway city, Marshfield city, 
Nixa city: Fremont Hills city, Battlefield town, 
Noel city: Lanagan town, South West City town, 
Norborne city: Dover town, 
Normandy city: Beverly Hills city, Bellerive village, Norwood Court town, Pasadena Park village, 
North Kansas City city: Kansas City city, Avondale city, 
North Lilbourn village: Lilbourn city, Catron town, 
Northmoor city: Houston Lake city, Oaks village, 
North Wardell village: Gideon city, Wardell town, 
Northwoods city: Beverly Hills city, Pine Lawn city, 
Norwood city: Mountain Grove city, Mansfield city, 
Norwood Court town: Country Club Hills city, Normandy city, Pasadena Hills city, 
Novelty town: Leonard town, Edina city, 
Novinger city: Kirksville city, 
Oak Grove city: Bates City village, Grain Valley city, 
Oak Grove village: Leslie village, Sullivan city, 
Oakland city: Glendale city, Crestwood city, 
Oakland Park village: Duquesne village, Joplin city, Webb City city, 
Oak Ridge town: Pocahontas town, Old Appleton town, Sedgewickville village, 
Oaks village: Northmoor city, Avondale city, Oakview village, Oakwood village, 
Oakview village: Gladstone city, Oaks village, Oakwood Park village, 
Oakville CDP: Arnold city, Mehlville CDP, 
Oakwood village: Oaks village, 
Oakwood Park village: Oakview village, 
Odessa city: Mayview city, Bates City village, 
O'Fallon city: Cottleville town, Dardenne Prairie town, 
Old Appleton town: Frohna city, Longtown town, Oak Ridge town, 
Old Monroe city: St. Paul village, Winfield city, 
Olean town: Eldon city, Eugene town, Russellville city, 
Olivette city: Overland city, 
Olympian Village city: De Soto city, Festus city, 
Oran city: Chaffee city, Morley city, 
Oregon city: Forest City city, 
Oronogo city: Alba city, Webb City city, 
Orrick city: Fleming city, 
Osage Beach city: Linn Creek city, Lake Ozark city, 
Osborn city: Cameron city, Turney village, 
Osceola city: Lowry City city, Roscoe village, Vista village, 
Osgood town: Harris town, Humphreys town, 
Otterville city: Smithton city, Syracuse city, 
Overland city: Olivette city, Breckenridge Hills village, 
Owensville city: Bland city, Rosebud city, 
Ozark city: Fremont Hills city, Sparta city, 
Pacific city: Gray Summit CDP, Eureka city, 
Pagedale city: Greendale city, 
Palmyra city: Hannibal city, 
Paris city: Holliday village, Stoutsville village, 
Parkdale town: High Ridge CDP, Murphy CDP, 
Parkville city: Platte Woods city, 
Parkway village: St. Clair city, 
Parma city: Catron town, Risco city, 
Parnell city: Ravenwood town, Sheridan town, 
Pasadena Hills city: Norwood Court town, 
Pasadena Park village: Normandy city, 
Pascola town: Bragg City town, Hayti Heights city, Homestown city, 
Passaic town: Butler city, Adrian city, 
Pattonsburg city: McFall city, Coffey town, 
Paynesville village: Annada town, Clarksville city, Eolia village, 
Peculiar city: Lake Annette village, Raymore city, 
Peerless Park village: Murphy CDP, Twin Oaks village, 
Penermon village: Baker village, Essex city, 
Perry city: The Landing village, 
Perryville city: Lithium village, Longtown town, 
Pevely city: Herculaneum city, Horine CDP, Barnhart CDP, 
Phelps City town: Rock Port city, Watson village, 
Phillipsburg town: Lebanon city, Conway city, 
Pickering town: Hopkins city, Maryville city, 
Piedmont city: Mill Spring village, Des Arc village, 
Pierce City city: Monett city, Wentworth village, 
Pilot Grove city: Blackwater city, Bunceton city, 
Pilot Knob city: Ironton city, Iron Mountain Lake city, 
Pine Lawn city: Northwoods city, Uplands Park village, 
Pineville town: Lanagan town, 
Platte City city: Farley village, Camden Point city, Tracy city, 
Platte Woods city: Parkville city, Lake Waukomis city, Weatherby Lake city, 
Plattsburg city: Lathrop city, 
Pleasant Hill city: Greenwood city, Baldwin Park village, 
Pleasant Hope city: Fair Grove city, Halfway village, Morrisville town, 
Pleasant Valley city: Glenaire village, Claycomo village, 
Pocahontas town: Oak Ridge town, Jackson city, 
Pollock village: Green City city, Milan city, Unionville city, 
Polo city: Cowgill city, Kingston city, Elmira village, 
Poplar Bluff city: Fisk city, Neelyville city, 
Portage Des Sioux city: Florissant city, 
Portageville city: Hayward town, Marston city, 
Potosi city: Mineral Point town, 
Powersville village: Lucerne village, 
Prairie Home city: Wooldridge town, 
Prathersville village: Missouri City city, Mosby city, Excelsior Springs city, 
Preston town: Cross Timbers city, Hermitage city, Urbana city, 
Princeton city: Mercer town, Spickard city, 
Purcell city: Neck City city, Alba city, 
Purdin city: Browning city, Linneus city, 
Purdy city: Butterfield village, Monett city, 
Puxico city: Dudley city, 
Queen City city: Glenwood village, Greentop city, 
Quitman town: Burlington Junction city, Skidmore city, 
Qulin city: Fisk city, 
Randolph village: Avondale city, Birmingham village, 
Ravenwood town: Parnell city, Clyde village, 
Raymondville town: Houston city, Licking city, Summersville city, 
Raymore city: Belton city, Peculiar city, Lake Winnebago city, 
Raytown city: Unity Village village, 
Rayville village: Richmond city, Woods Heights city, 
Rea town: Rosendale city, 
Redings Mill village: Cliff Village village, Seneca city, 
Reeds town: Avilla town, Sarcoxie city, 
Reeds Spring city: Lakeview city, Galena city, 
Renick village: Clark city, Higbee city, Moberly city, 
Republic city: Brookline village, Clever city, 
Revere town: Kahoka city, Wayland city, 
Rhineland town: Gasconade city, McKittrick town, 
Richards town: Deerfield village, Stotesbury town, 
Rich Hill city: Metz town, 
Richland city: Crocker city, Stoutland village, 
Richmond city: Rayville village, Henrietta city, 
Richmond Heights city: Clayton city, Maplewood city, 
Ridgely town: Camden Point city, Edgerton city, Smithville city, 
Ridgeway city: Blythedale village, Bethany city, 
Risco city: Parma city, Tallapoosa city, 
Ritchey town: Granby city, Newtonia town, Wentworth village, 
Rivermines village: Elvins city, 
Riverside city: Houston Lake city, 
Riverview village: Glasgow Village CDP, Bellefontaine Neighbors city, 
Rocheport city: Wooldridge town, 
Rockaway Beach city: Forsyth city, Merriam Woods village, 
Rock Hill city: Ladue city, Brentwood city, 
Rock Port city: Phelps City town, Tarkio city, 
Rockville city: Appleton City city, Schell City city, 
Rocky Ridge village: Bloomsdale city, 
Rogersville town: Fordland city, Sparta city, 
Rolla city: Doolittle city, St. James city, 
Roscoe village: Osceola city, 
Rosebud city: Gerald city, Owensville city, 
Rosendale city: Bolckow city, Fillmore city, Rea town, Savannah city, 
Rothville village: Brookfield city, Marceline city, Mendon town, 
Rush Hill town: Benton City town, Laddonia city, 
Rushville town: De Kalb town, Lewis and Clark Village town, 
Russellville city: Olean town, Lohman town, 
Rutledge town: Baring city, South Gorin town, 
Saginaw village: Leawood village, Silver Creek village, 
St. Ann city: Bridgeton city, Breckenridge Hills village, 
St. Charles city: Maryland Heights city, 
St. Clair city: Parkway village, Union city, 
St. Cloud village: Bourbon city, Sullivan city, 
Ste. Genevieve city: Bloomsdale city, St. Mary city, 
St. Elizabeth town: Iberia city, Meta city, 
St. George city: Bella Villa city, Mehlville CDP, Affton CDP, Wilbur Park village, 
St. James city: Rolla city, 
St. John city: Breckenridge Hills village, Charlack city, 
St. Joseph city: Country Club village, Agency town, 
St. Louis city: Wellston city, 
St. Martins city: Hartsburg town, Jefferson City city, Lohman town, Centertown town, 
St. Mary city: Ste. Genevieve city, Lithium village, 
St. Paul village: Old Monroe city, Josephville village, 
St. Peters city: Cottleville town, 
St. Robert city: Fort Leonard Wood CDP, Waynesville city, 
St. Thomas town: Meta city, Wardsville town, 
Salem city: Edgar Springs city, 
Salisbury city: Clifton Hill city, Keytesville city, 
Sappington CDP: Concord CDP, 
Sarcoxie city: Reeds town, Wentworth village, 
Savannah city: Rosendale city, Amazonia town, 
Schell City city: Harwood town, Rockville city, 
Scotsdale town: Cedar Hill CDP, Byrnes Mill city, 
Scott City city: Cape Girardeau city, Commerce town, Kelso town, 
Sedalia city: Hughesville village, Smithton city, 
Sedgewickville village: Oak Ridge town, 
Seligman city: Washburn city, 
Senath city: Arbyrd city, Hornersville city, Kennett city, 
Seneca city: Redings Mill village, 
Seymour city: Mansfield city, Diggins village, 
Shelbina city: Hunnewell city, Shelbyville city, 
Shelbyville city: Shelbina city, Bethel town, 
Sheldon city: Milford village, Milo town, 
Sheridan town: Parnell city, 
Shoal Creek Drive village: Iron Gates village, Cliff Village village, 
Shoal Creek Estates town: Leawood village, 
Shrewsbury city: Maplewood city, Mac Kenzie village, 
Sibley village: Buckner city, 
Sikeston city: Miner city, Morehouse city, 
Silex village: Cave town, Whiteside village, 
Silver Creek village: Saginaw village, 
Skidmore city: Quitman town, Maitland city, 
Slater city: Marshall city, Gilliam town, 
Smithton city: Otterville city, Sedalia city, 
Smithville city: Ridgely town, Ferrelview village, 
South Gifford village: Millard village, Elmer city, 
South Gorin town: Arbela town, Rutledge town, 
South Greenfield village: Everton city, Lockwood city, Greenfield city, 
South Lineville town: Mercer town, 
South West City town: Noel city, 
Spanish Lake CDP: Glasgow Village CDP, 
Sparta city: Rogersville town, Ozark city, 
Spickard city: Princeton city, Tindall town, 
Springfield city: Battlefield town, 
Stanberry city: Ford City town, Clyde village, 
Stark City town: Fairview town, Newtonia town, Stella town, 
Steele city: Cooter city, Holland town, Hayti Heights city, 
Steelville city: Cuba city, 
Stella town: Stark City town, 
Stewartsville city: Clarksdale city, 
Stockton city: Umber View Heights village, 
Stotesbury town: Hume town, Metz town, Richards town, 
Stotts City city: Freistatt town, 
Stoutland village: Richland city, 
Stoutsville village: Florida village, Paris city, Hunnewell city, 
Stover city: Versailles city, 
Strafford city: Fair Grove city, 
Strasburg town: Baldwin Park village, Kingsville city, Gunn City village, 
Sturgeon city: Hallsville city, Clark city, 
Sugar Creek city: Birmingham village, Independence city, 
Sullivan city: St. Cloud village, Oak Grove village, 
Summersville city: Mountain View city, Raymondville town, 
Sumner town: Mendon town, Hale city, 
Sundown village: Gainesville city, Theodosia village, 
Sunrise Beach village: Laurie village, Village of Four Seasons town, 
Sunset Hills city: Crestwood city, Fenton city, 
Sweet Springs city: Houstonia city, Emma city, 
Sycamore Hills village: Charlack city, 
Syracuse city: Otterville city, Tipton city, 
Table Rock village: Blue Eye town, Branson city, Indian Point village, 
Tallapoosa city: Risco city, Gideon city, 
Taneyville village: Forsyth city, 
Taos city: Wardsville town, Westphalia city, 
Tarkio city: Rock Port city, Fairfax city, Westboro city, 
Tarrants village: Louisiana city, Bowling Green city, 
Thayer city: Alton city, Koshkonong town, 
The Landing village: Center city, Perry city, Monroe City city, 
Theodosia village: Sundown village, 
Tightwad village: Calhoun city, 
Tina town: Bosworth city, Hale city, Bogard city, 
Tindall town: Spickard city, Brimson village, Trenton city, 
Tipton city: Bunceton city, Clarksburg city, Syracuse city, 
Town and Country city: Country Life Acres village, 
Tracy city: Platte City city, Weston city, 
Trenton city: Tindall town, 
Trimble city: Edgerton city, 
Triplett city: Brunswick city, Mendon town, 
Troy city: Moscow Mills city, Cave town, 
Truesdale city: Wright City city, Warrenton city, 
Truxton village: Hawk Point city, Bellflower city, 
Turney village: Osborn city, Lathrop city, 
Tuscumbia town: Brumley town, Eugene town, 
Twin Bridges town: Lebanon city, 
Twin Oaks village: Peerless Park village, Manchester city, Valley Park city, 
Umber View Heights village: Stockton city, Arcola village, 
Union city: St. Clair city, Villa Ridge CDP, Washington city, 
Union Star town: King City city, 
Unionville city: Pollock village, 
Unity Village village: Raytown city, Lee's Summit city, 
University City city: Hanley Hills village, Clayton city, 
Uplands Park village: Pine Lawn city, Velda Village Hills village, 
Urbana city: Preston town, Louisburg village, 
Urich city: Blairstown city, Hartwell village, Creighton city, 
Utica village: Chillicothe city, Mooresville village, 
Valley Park city: Fenton city, Twin Oaks village, 
Van Buren town: Ellington city, Grandin city, 
Vandalia city: Farber city, Curryville city, 
Vandiver village: Auxvasse city, Mexico city, Benton City town, 
Vanduser village: Bell City city, Hay-Wood City village, 
Velda Village city: Beverly Hills city, 
Velda Village Hills village: Uplands Park village, 
Verona town: Freistatt town, Aurora city, 
Versailles city: Stover city, Gravois Mills village, 
Viburnum town: Bunker city, 
Vienna city: Freeburg village, 
Village of Four Seasons town: Sunrise Beach village, Lake Ozark city, 
Villa Ridge CDP: Augusta city, Union city, Gray Summit CDP, 
Vinita Park city: Charlack city, Vinita Terrace village, 
Vinita Terrace village: Vinita Park city, Hanley Hills village, 
Vista village: Gerster town, Osceola city, 
Waco town: Asbury city, Carl Junction city, 
Wakenda town: Carrollton city, Malta Bend town, 
Walker city: Nevada city, Harwood town, 
Walnut Grove city: Aldrich village, Morrisville town, Ash Grove city, 
Wardell town: Homestown city, North Wardell village, 
Wardsville town: St. Thomas town, Taos city, Jefferson City city, 
Warrensburg city: Centerview town, 
Warrenton city: Truesdale city, 
Warsaw city: Lincoln city, 
Warson Woods city: Huntleigh city, Glendale city, 
Washburn city: Seligman city, Exeter city, 
Washington city: Marthasville city, Union city, 
Watson village: Phelps City town, 
Waverly city: Grand Pass town, 
Wayland city: Alexandria city, Revere town, 
Waynesville city: St. Robert city, Crocker city, 
Weatherby town: Winston town, 
Weatherby Lake city: Ferrelview village, Platte Woods city, 
Weaubleau city: Flemington village, Gerster town, 
Webb City city: Airport Drive village, Oakland Park village, Oronogo city, Carterville city, 
Webster Groves city: Marlborough village, 
Weldon Spring town: Chesterfield city, Cottleville town, Weldon Spring Heights town, 
Weldon Spring Heights town: Weldon Spring town, 
Wellington city: Camden city, 
Wellston city: St. Louis city, Hillsdale village, 
Wellsville city: Montgomery City city, Martinsburg town, 
Wentworth village: Ritchey town, Sarcoxie city, Pierce City city, 
Wentzville city: Foristell city, New Melle village, Flint Hill village, 
Westboro city: Tarkio city, 
West Line village: Cleveland town, Lake Annette village, 
Weston city: Iatan village, Tracy city, 
Westphalia city: Linn city, Taos city, 
West Plains city: Bakersfield village, Brandsville city, Willow Springs city, 
Westwood village: Creve Coeur city, Frontenac city, 
Wheatland city: Hermitage city, 
Wheaton city: Fairview town, 
Wheeling city: Meadville city, 
Whiteman AFB CDP: Knob Noster city, 
Whiteside village: Eolia village, Silex village, 
Whitewater town: Allenville village, 
Wilbur Park village: St. George city, 
Willard city: Brookline village, 
Williamsville city: Greenville city, Mill Spring village, 
Willow Springs city: West Plains city, Cabool city, 
Wilson City town: Charleston city, Wyatt city, 
Winchester city: Manchester city, Ballwin city, 
Windsor city: Calhoun city, Green Ridge town, 
Winfield city: Foley city, Old Monroe city, 
Winona city: Eminence city, Birch Tree city, 
Winston town: Altamont town, Weatherby town, Kidder city, 
Woods Heights city: Crystal Lakes village, Rayville village, 
Woodson Terrace city: Berkeley city, Edmundson village, 
Wooldridge town: Prairie Home city, Rocheport city, Lupus town, 
Worth town: Grant City town, Gentry village, 
Worthington village: Livonia village, 
Wright City city: Truesdale city, Foristell city, 
Wyaconda city: Luray town, 
Wyatt city: Wilson City town, 
Zalma village: Glenallen town, Advance city, 
